PokerStars Game #20107222971: Tournament #999999999, 1FPP Hold'em No Limit - Level I (25/50) - 2010/06/04 19:46:11 WET [2010/06/04 14:46:11 ET]
Table '999999998 11' 6-max Seat #1 is the button
Seat 1: Player6 (300 in chips) 
Seat 2: Player21 (300 in chips) 
Seat 3: Player12 (300 in chips) 
Seat 4: Player11 (600 in chips) 
Seat 5: Hero (300 in chips) 
Seat 6: Player0 (300 in chips) 
Player6: posts the ante 10
Player21: posts the ante 10
Player12: posts the ante 10
Player11: posts the ante 10
Hero: posts the ante 10
Player0: posts the ante 10
Player21: posts small blind 25
Player12: posts big blind 50
*** HOLE CARDS ***
Dealt to Hero [4s 9d]
Player11: raises 540 to 590 and is all-in
Hero: calls 290 and is all-in
Player0: folds 
Player6: calls 290 and is all-in
Player21: folds 
Player12: calls 240 and is all-in
Uncalled bet (300) returned to Player11
*** FLOP *** [4c 5d Ts]
*** TURN *** [4c 5d Ts] [Js]
*** RIVER *** [4c 5d Ts Js] [7c]
*** SHOW DOWN ***
Player12: shows [3c Kh] (high card King)
Player11: shows [8h 7s] (a pair of Sevens)
Hero: shows [4s 9d] (a pair of Fours)
Player6: shows [Qc Td] (a pair of Tens)
Player6 collected 1245 from pot
Hero re-buys and receives 600 chips for 2 FPPs
Player12 re-buys and receives 300 chips for 1 FPPs
*** SUMMARY ***
Total pot 1245 | Rake 0 
Board [4c 5d Ts Js 7c]
Seat 1: Player6 (button) showed [Qc Td] and won (1245) with a pair of Tens
Seat 2: Player21 (small blind) folded before Flop
Seat 3: Player12 (big blind) showed [3c Kh] and lost with high card King
Seat 4: Player11 showed [8h 7s] and lost with a pair of Sevens
Seat 5: Hero showed [4s 9d] and lost with a pair of Fours
Seat 6: Player0 folded before Flop (didn't bet)



PokerStars Game #26543131325: Tournament #999999999, 1FPP Hold'em No Limit - Level I (25/50) - 2010/06/04 19:47:00 WET [2010/06/04 14:47:00 ET]
Table '999999998 11' 6-max Seat #2 is the button
Seat 1: Player6 (1245 in chips) 
Seat 2: Player21 (265 in chips) 
Seat 3: Player12 (300 in chips) 
Seat 4: Player11 (300 in chips) 
Seat 5: Hero (600 in chips) 
Seat 6: Player0 (290 in chips) 
Player6: posts the ante 10
Player21: posts the ante 10
Player12: posts the ante 10
Player11: posts the ante 10
Hero: posts the ante 10
Player0: posts the ante 10
Player12: posts small blind 25
Player11: posts big blind 50
*** HOLE CARDS ***
Dealt to Hero [Qs 7c]
Hero: raises 540 to 590 and is all-in
Player0: folds 
Player6: raises 540 to 1130
Player21: folds 
Player12: calls 265 and is all-in
Player11: calls 240 and is all-in
Uncalled bet (540) returned to Player6
*** FLOP *** [Jc 4c 5d]
*** TURN *** [Jc 4c 5d] [3c]
*** RIVER *** [Jc 4c 5d 3c] [3h]
*** SHOW DOWN ***
Hero: shows [Qs 7c] (a pair of Threes)
Player6: shows [Ah 8c] (a pair of Threes - Ace kicker)
Player6 collected 600 from side pot
Player12: shows [8s Qd] (a pair of Threes - lower kicker)
Player11: shows [2c Jh] (two pair, Jacks and Threes)
Player11 collected 1220 from main pot
Hero re-buys and receives 600 chips for 2 FPPs
Player12 re-buys and receives 300 chips for 1 FPPs
*** SUMMARY ***
Total pot 1820 Main pot 1220. Side pot 600. | Rake 0 
Board [Jc 4c 5d 3c 3h]
Seat 1: Player6 showed [Ah 8c] and won (600) with a pair of Threes
Seat 2: Player21 (button) folded before Flop (didn't bet)
Seat 3: Player12 (small blind) showed [8s Qd] and lost with a pair of Threes
Seat 4: Player11 (big blind) showed [2c Jh] and won (1220) with two pair, Jacks and Threes
Seat 5: Hero showed [Qs 7c] and lost with a pair of Threes
Seat 6: Player0 folded before Flop (didn't bet)



PokerStars Game #76601810212: Tournament #999999999, 1FPP Hold'em No Limit - Level I (25/50) - 2010/06/04 19:47:47 WET [2010/06/04 14:47:47 ET]
Table '999999998 11' 6-max Seat #3 is the button
Seat 1: Player6 (1245 in chips) 
Seat 2: Player21 (255 in chips) 
Seat 3: Player12 (300 in chips) 
Seat 4: Player11 (1220 in chips) 
Seat 5: Hero (600 in chips) 
Seat 6: Player0 (280 in chips) 
Player6: posts the ante 10
Player21: posts the ante 10
Player12: posts the ante 10
Player11: posts the ante 10
Hero: posts the ante 10
Player0: posts the ante 10
Player11: posts small blind 25
Hero: posts big blind 50
*** HOLE CARDS ***
Dealt to Hero [2h Qd]
Player0: raises 150 to 200
Player6: folds 
Player21: folds 
Player12: folds 
Player11: folds 
Hero: raises 350 to 550
Player0: calls 70 and is all-in
Uncalled bet (280) returned to Hero
*** FLOP *** [9s Ks Th]
*** TURN *** [9s Ks Th] [Jc]
*** RIVER *** [9s Ks Th Jc] [5h]
*** SHOW DOWN ***
Hero: shows [2h Qd] (a straight, Nine to King)
Player0: shows [As Jd] (a pair of Jacks)
Hero collected 625 from pot
Player0 finished the tournament in 273rd place
*** SUMMARY ***
Total pot 625 | Rake 0 
Board [9s Ks Th Jc 5h]
Seat 1: Player6 folded before Flop (didn't bet)
Seat 2: Player21 folded before Flop (didn't bet)
Seat 3: Player12 (button) folded before Flop (didn't bet)
Seat 4: Player11 (small blind) folded before Flop
Seat 5: Hero (big blind) showed [2h Qd] and won (625) with a straight, Nine to King
Seat 6: Player0 showed [As Jd] and lost with a pair of Jacks



PokerStars Game #28346217223: Tournament #999999999, 1FPP Hold'em No Limit - Level I (25/50) - 2010/06/04 19:48:21 WET [2010/06/04 14:48:21 ET]
Table '999999998 11' 6-max Seat #4 is the button
Seat 1: Player6 (1235 in chips) 
Seat 2: Player21 (245 in chips) 
Seat 3: Player12 (290 in chips) 
Seat 4: Player11 (1185 in chips) 
Seat 5: Hero (945 in chips) 
Player6: posts the ante 10
Player21: posts the ante 10
Player12: posts the ante 10
Player11: posts the ante 10
Hero: posts the ante 10
Hero: posts small blind 25
Player6: posts big blind 50
*** HOLE CARDS ***
Dealt to Hero [6d Jc]
Player21: raises 185 to 235 and is all-in
Player12: folds 
Player11: calls 235
Hero: raises 185 to 420
Player6: raises 805 to 1225 and is all-in
Player11: calls 940 and is all-in
Hero: calls 515 and is all-in
Uncalled bet (50) returned to Player6
Player13 is connected 
*** FLOP *** [5c As Ts]
*** TURN *** [5c As Ts] [6c]
*** RIVER *** [5c As Ts 6c] [6h]
*** SHOW DOWN ***
Player6: shows [8h 9d] (a pair of Sixes)
Player11: shows [2h 2s] (two pair, Sixes and Deuces)
Player11 collected 480 from side pot-2 
Hero: shows [6d Jc] (three of a kind, Sixes)
Hero collected 2100 from side pot-1 
Player21: shows [Tc Ah] (two pair, Aces and Tens)
Hero collected 990 from main pot
Player21 re-buys and receives 300 chips for 1 FPPs
*** SUMMARY ***
Total pot 3570 Main pot 990. Side pot-1 2100. Side pot-2 480. | Rake 0 
Board [5c As Ts 6c 6h]
Seat 1: Player6 (big blind) showed [8h 9d] and lost with a pair of Sixes
Seat 2: Player21 showed [Tc Ah] and lost with two pair, Aces and Tens
Seat 3: Player12 folded before Flop (didn't bet)
Seat 4: Player11 (button) showed [2h 2s] and won (480) with two pair, Sixes and Deuces
Seat 5: Hero (small blind) showed [6d Jc] and won (3090) with three of a kind, Sixes



PokerStars Game #53469813066: Tournament #999999999, 1FPP Hold'em No Limit - Level I (25/50) - 2010/06/04 19:49:10 WET [2010/06/04 14:49:10 ET]
Table '999999998 11' 6-max Seat #5 is the button
Seat 1: Player6 (50 in chips) 
Seat 2: Player21 (300 in chips) 
Seat 3: Player12 (280 in chips) 
Seat 4: Player11 (480 in chips) 
Seat 5: Hero (3090 in chips) 
Seat 6: Player13 (1475 in chips) out of hand (moved from another table into small blind)
Player6: posts the ante 10
Player21: posts the ante 10
Player12: posts the ante 10
Player11: posts the ante 10
Hero: posts the ante 10
Player6: posts small blind 25
Player21: posts big blind 50
*** HOLE CARDS ***
Dealt to Hero [9h Qd]
Player6 re-buys and receives 300 chips for 1 FPPs
Player12: raises 220 to 270 and is all-in
Player11: folds 
Hero: raises 1230 to 1500
Player6: calls 15 and is all-in
Player21: folds 
Uncalled bet (1230) returned to Hero
*** FLOP *** [2h 8c 5h]
*** TURN *** [2h 8c 5h] [Ac]
*** RIVER *** [2h 8c 5h Ac] [2s]
*** SHOW DOWN ***
Player12: shows [Kh 6h] (a pair of Deuces)
Hero: shows [9h Qd] (a pair of Deuces - lower kicker)
Player12 collected 470 from side pot
Player6: shows [As 8s] (two pair, Aces and Eights)
Player12 is sitting out
Player6 collected 210 from main pot
*** SUMMARY ***
Total pot 680 Main pot 210. Side pot 470. | Rake 0 
Board [2h 8c 5h Ac 2s]
Seat 1: Player6 (small blind) showed [As 8s] and won (210) with two pair, Aces and Eights
Seat 2: Player21 (big blind) folded before Flop
Seat 3: Player12 showed [Kh 6h] and won (470) with a pair of Deuces
Seat 4: Player11 folded before Flop (didn't bet)
Seat 5: Hero (button) showed [9h Qd] and lost with a pair of Deuces



PokerStars Game #17659192331: Tournament #999999999, 1FPP Hold'em No Limit - Level II (50/100) - 2010/06/04 19:49:47 WET [2010/06/04 14:49:47 ET]
Table '999999998 11' 6-max Seat #1 is the button
Seat 1: Player6 (510 in chips) 
Seat 2: Player21 (240 in chips) 
Seat 3: Player12 (470 in chips) is sitting out
Seat 4: Player11 (470 in chips) 
Seat 5: Hero (2810 in chips) 
Seat 6: Player13 (1475 in chips) 
Player6: posts the ante 20
Player21: posts the ante 20
Player12: posts the ante 20
Player11: posts the ante 20
Hero: posts the ante 20
Player13: posts the ante 20
Player21: posts small blind 50
Player12: posts big blind 100
*** HOLE CARDS ***
Dealt to Hero [Jc Td]
Player11: raises 350 to 450 and is all-in
Hero: raises 2340 to 2790 and is all-in
Player13: folds 
Player6: calls 490 and is all-in
Player21: folds 
Player12: folds 
Uncalled bet (2300) returned to Hero
*** FLOP *** [2c 4h 3c]
*** TURN *** [2c 4h 3c] [Ac]
*** RIVER *** [2c 4h 3c Ac] [9c]
*** SHOW DOWN ***
Hero: shows [Jc Td] (a flush, Ace high)
Player6: shows [Th Ks] (high card Ace)
Hero collected 80 from side pot
Player11: shows [8h 9d] (a pair of Nines)
Hero collected 1620 from main pot
Player11 re-buys and receives 600 chips for 2 FPPs
Player6 re-buys and receives 600 chips for 2 FPPs
*** SUMMARY ***
Total pot 1700 Main pot 1620. Side pot 80. | Rake 0 
Board [2c 4h 3c Ac 9c]
Seat 1: Player6 (button) showed [Th Ks] and lost with high card Ace
Seat 2: Player21 (small blind) folded before Flop
Seat 3: Player12 (big blind) folded before Flop
Seat 4: Player11 showed [8h 9d] and lost with a pair of Nines
Seat 5: Hero showed [Jc Td] and won (1700) with a flush, Ace high
Seat 6: Player13 folded before Flop (didn't bet)



PokerStars Game #15161114072: Tournament #999999999, 1FPP Hold'em No Limit - Level II (50/100) - 2010/06/04 19:50:46 WET [2010/06/04 14:50:46 ET]
Table '999999998 11' 6-max Seat #2 is the button
Seat 1: Player6 (600 in chips) 
Seat 2: Player21 (170 in chips) 
Seat 3: Player12 (350 in chips) is sitting out
Seat 4: Player11 (600 in chips) 
Seat 5: Hero (4000 in chips) 
Seat 6: Player13 (1455 in chips) 
Player6: posts the ante 20
Player21: posts the ante 20
Player12: posts the ante 20
Player11: posts the ante 20
Hero: posts the ante 20
Player13: posts the ante 20
Player12: posts small blind 50
Player11: posts big blind 100
*** HOLE CARDS ***
Dealt to Hero [Jd 6s]
Hero: raises 3880 to 3980 and is all-in
Player13: calls 1435 and is all-in
Player6: folds 
Player21: folds 
Player12: folds 
Player11: calls 480 and is all-in
Uncalled bet (2545) returned to Hero
*** FLOP *** [Kd 9s Qh]
*** TURN *** [Kd 9s Qh] [Ts]
*** RIVER *** [Kd 9s Qh Ts] [7c]
*** SHOW DOWN ***
Hero: shows [Jd 6s] (a straight, Nine to King)
Player13: shows [Kc As] (a pair of Kings)
Hero collected 1710 from side pot
Player11: shows [8s 4h] (high card King)
Hero collected 1910 from main pot
Player13 re-buys and receives 600 chips for 2 FPPs
Player11 re-buys and receives 600 chips for 2 FPPs
*** SUMMARY ***
Total pot 3620 Main pot 1910. Side pot 1710. | Rake 0 
Board [Kd 9s Qh Ts 7c]
Seat 1: Player6 folded before Flop (didn't bet)
Seat 2: Player21 (button) folded before Flop (didn't bet)
Seat 3: Player12 (small blind) folded before Flop
Seat 4: Player11 (big blind) showed [8s 4h] and lost with high card King
Seat 5: Hero showed [Jd 6s] and won (3620) with a straight, Nine to King
Seat 6: Player13 showed [Kc As] and lost with a pair of Kings



PokerStars Game #57039811101: Tournament #999999999, 1FPP Hold'em No Limit - Level II (50/100) - 2010/06/04 19:51:17 WET [2010/06/04 14:51:17 ET]
Table '999999998 11' 6-max Seat #3 is the button
Seat 1: Player6 (580 in chips) 
Seat 2: Player21 (150 in chips) 
Seat 3: Player12 (280 in chips) is sitting out
Seat 4: Player11 (600 in chips) 
Seat 5: Hero (6165 in chips) 
Seat 6: Player13 (600 in chips) 
Player6: posts the ante 20
Player21: posts the ante 20
Player12: posts the ante 20
Player11: posts the ante 20
Hero: posts the ante 20
Player13: posts the ante 20
Player11: posts small blind 50
Hero: posts big blind 100
*** HOLE CARDS ***
Dealt to Hero [6s Kd]
Player13: raises 480 to 580 and is all-in
Player6: folds 
Player21: folds 
Player12: folds 
Player11: calls 530 and is all-in
Hero: calls 480
*** FLOP *** [Tc 6c 7c]
*** TURN *** [Tc 6c 7c] [2c]
*** RIVER *** [Tc 6c 7c 2c] [Qs]
*** SHOW DOWN ***
Player11: shows [Ks 3h] (high card King)
Hero: shows [6s Kd] (a pair of Sixes)
Player13: shows [9s 2d] (a pair of Deuces)
Hero collected 1860 from pot
Player13 re-buys and receives 600 chips for 2 FPPs
Player11 re-buys and receives 600 chips for 2 FPPs
*** SUMMARY ***
Total pot 1860 | Rake 0 
Board [Tc 6c 7c 2c Qs]
Seat 1: Player6 folded before Flop (didn't bet)
Seat 2: Player21 folded before Flop (didn't bet)
Seat 3: Player12 (button) folded before Flop (didn't bet)
Seat 4: Player11 (small blind) showed [Ks 3h] and lost with high card King
Seat 5: Hero (big blind) showed [6s Kd] and won (1860) with a pair of Sixes
Seat 6: Player13 showed [9s 2d] and lost with a pair of Deuces



PokerStars Game #90281799521: Tournament #999999999, 1FPP Hold'em No Limit - Level II (50/100) - 2010/06/04 19:51:46 WET [2010/06/04 14:51:46 ET]
Table '999999998 11' 6-max Seat #4 is the button
Seat 1: Player6 (560 in chips) 
Seat 2: Player21 (130 in chips) 
Seat 3: Player12 (260 in chips) is sitting out
Seat 4: Player11 (600 in chips) 
Seat 5: Hero (7425 in chips) 
Seat 6: Player13 (600 in chips) 
Player6: posts the ante 20
Player21: posts the ante 20
Player12: posts the ante 20
Player11: posts the ante 20
Hero: posts the ante 20
Player13: posts the ante 20
Hero: posts small blind 50
Player13: posts big blind 100
*** HOLE CARDS ***
Dealt to Hero [8d 9h]
Player6: raises 440 to 540 and is all-in
Player21: calls 110 and is all-in
Player12: folds 
Player11: calls 540
Hero: calls 490
Player13: raises 40 to 580 and is all-in
Player11: calls 40 and is all-in
Hero: calls 40
*** FLOP *** [Td 4s Th]
*** TURN *** [Td 4s Th] [Qd]
*** RIVER *** [Td 4s Th Qd] [Qs]
*** SHOW DOWN ***
Hero: shows [8d 9h] (two pair, Queens and Tens)
Player13: shows [3d 3h] (two pair, Queens and Tens - lower kicker)
Player11: shows [9c 3s] (two pair, Queens and Tens)
Hero collected 60 from side pot-2 
Player11 collected 60 from side pot-2 
Player6: shows [Kh 7d] (two pair, Queens and Tens - King kicker)
Player6 collected 1720 from side pot-1 
Player21: shows [Kd Qc] (a full house, Queens full of Tens)
Player21 collected 670 from main pot
Player13 has timed out while disconnected
Player13 is sitting out
Player13 finished the tournament in 224th place
*** SUMMARY ***
Total pot 2510 Main pot 670. Side pot-1 1720. Side pot-2 120. | Rake 0 
Board [Td 4s Th Qd Qs]
Seat 1: Player6 showed [Kh 7d] and won (1720) with two pair, Queens and Tens
Seat 2: Player21 showed [Kd Qc] and won (670) with a full house, Queens full of Tens
Seat 3: Player12 folded before Flop (didn't bet)
Seat 4: Player11 (button) showed [9c 3s] and won (60) with two pair, Queens and Tens
Seat 5: Hero (small blind) showed [8d 9h] and won (60) with two pair, Queens and Tens
Seat 6: Player13 (big blind) showed [3d 3h] and lost with two pair, Queens and Tens



PokerStars Game #21189900419: Tournament #999999999, 1FPP Hold'em No Limit - Level III (100/200) - 2010/06/04 19:52:40 WET [2010/06/04 14:52:40 ET]
Table '999999998 11' 6-max Seat #5 is the button
Seat 1: Player6 (1720 in chips) 
Seat 2: Player21 (670 in chips) 
Seat 3: Player12 (240 in chips) is sitting out
Seat 4: Player11 (60 in chips) 
Seat 5: Hero (6885 in chips) 
Player6: posts the ante 40
Player21: posts the ante 40
Player12: posts the ante 40
Player11: posts the ante 40
Hero: posts the ante 40
Player6: posts small blind 100
Player21: posts big blind 200
*** HOLE CARDS ***
Dealt to Hero [Td 9d]
Player12: folds 
Player11: calls 20 and is all-in
Player7 is connected 
Hero: raises 6645 to 6845 and is all-in
Player6: folds 
Player21: folds 
Uncalled bet (6645) returned to Hero
*** FLOP *** [9s As 2s]
*** TURN *** [9s As 2s] [4h]
*** RIVER *** [9s As 2s 4h] [5h]
*** SHOW DOWN ***
Hero: shows [Td 9d] (a pair of Nines)
Hero collected 440 from side pot
Player11: shows [Jh 7s] (high card Ace)
Hero collected 280 from main pot
Player11 re-buys and receives 600 chips for 2 FPPs
*** SUMMARY ***
Total pot 720 Main pot 280. Side pot 440. | Rake 0 
Board [9s As 2s 4h 5h]
Seat 1: Player6 (small blind) folded before Flop
Seat 2: Player21 (big blind) folded before Flop
Seat 3: Player12 folded before Flop (didn't bet)
Seat 4: Player11 showed [Jh 7s] and lost with high card Ace
Seat 5: Hero (button) showed [Td 9d] and won (720) with a pair of Nines



PokerStars Game #16652117062: Tournament #999999999, 1FPP Hold'em No Limit - Level III (100/200) - 2010/06/04 19:53:18 WET [2010/06/04 14:53:18 ET]
Table '999999998 11' 6-max Seat #1 is the button
Seat 1: Player6 (1580 in chips) 
Seat 2: Player21 (430 in chips) 
Seat 3: Player12 (200 in chips) is sitting out
Seat 4: Player11 (600 in chips) 
Seat 5: Hero (7365 in chips) 
Seat 6: Player7 (600 in chips) 
Player6: posts the ante 40
Player21: posts the ante 40
Player12: posts the ante 40
Player11: posts the ante 40
Hero: posts the ante 40
Player7: posts the ante 40
Player21: posts small blind 100
Player12: posts big blind 160 and is all-in
*** HOLE CARDS ***
Dealt to Hero [2c 4d]
Player11: raises 400 to 560 and is all-in
Hero: raises 6765 to 7325 and is all-in
Player7: calls 560 and is all-in
Player6: folds 
Player21: calls 290 and is all-in
Player12: folds 
Uncalled bet (6765) returned to Hero
*** FLOP *** [3s Js 5c]
*** TURN *** [3s Js 5c] [9c]
*** RIVER *** [3s Js 5c 9c] [7d]
*** SHOW DOWN ***
Player11: shows [Qc Jc] (a pair of Jacks)
Hero: shows [2c 4d] (high card Jack)
Player7: shows [Qd Jh] (a pair of Jacks)
Player11 collected 255 from side pot-2 
Player7 collected 255 from side pot-2 
Player21: shows [As Ac] (a pair of Aces)
Player21 collected 920 from side pot-1 
Player21 collected 1040 from main pot
Player12 finished the tournament in 214th place
*** SUMMARY ***
Total pot 2470 Main pot 1040. Side pot-1 920. Side pot-2 510. | Rake 0 
Board [3s Js 5c 9c 7d]
Seat 1: Player6 (button) folded before Flop (didn't bet)
Seat 2: Player21 (small blind) showed [As Ac] and won (1960) with a pair of Aces
Seat 3: Player12 (big blind) folded before Flop
Seat 4: Player11 showed [Qc Jc] and won (255) with a pair of Jacks
Seat 5: Hero showed [2c 4d] and lost with high card Jack
Seat 6: Player7 showed [Qd Jh] and won (255) with a pair of Jacks



PokerStars Game #18934320061: Tournament #999999999, 1FPP Hold'em No Limit - Level III (100/200) - 2010/06/04 19:54:02 WET [2010/06/04 14:54:02 ET]
Table '999999998 11' 6-max Seat #2 is the button
Seat 1: Player6 (1540 in chips) 
Seat 2: Player21 (1960 in chips) 
Seat 4: Player11 (255 in chips) 
Seat 5: Hero (6765 in chips) 
Seat 6: Player7 (255 in chips) 
Player6: posts the ante 40
Player21: posts the ante 40
Player11: posts the ante 40
Hero: posts the ante 40
Player7: posts the ante 40
Player11: posts small blind 100
Hero: posts big blind 200
*** HOLE CARDS ***
Dealt to Hero [Ts 9h]
Player7: raises 15 to 215 and is all-in
Player6: calls 215
Player21: folds 
Player11: calls 115 and is all-in
Player16 is connected 
Hero: calls 15
*** FLOP *** [8h Td 7s]
Hero: checks 
Player6: bets 400
Hero: raises 800 to 1200
Player6: raises 85 to 1285 and is all-in
Hero: calls 85
*** TURN *** [8h Td 7s] [6s]
*** RIVER *** [8h Td 7s 6s] [Kd]
*** SHOW DOWN ***
Hero: shows [Ts 9h] (a straight, Six to Ten)
Player6: shows [Jh Tc] (a pair of Tens)
Hero collected 2570 from side pot
Player7: shows [Ah 9d] (a straight, Six to Ten)
Player11: shows [9s Qd] (a straight, Six to Ten)
Player11 collected 354 from main pot
Hero collected 353 from main pot
Player7 collected 353 from main pot
Player6 re-buys and receives 600 chips for 2 FPPs
*** SUMMARY ***
Total pot 3630 Main pot 1060. Side pot 2570. | Rake 0 
Board [8h Td 7s 6s Kd]
Seat 1: Player6 showed [Jh Tc] and lost with a pair of Tens
Seat 2: Player21 (button) folded before Flop (didn't bet)
Seat 4: Player11 (small blind) showed [9s Qd] and won (354) with a straight, Six to Ten
Seat 5: Hero (big blind) showed [Ts 9h] and won (2923) with a straight, Six to Ten
Seat 6: Player7 showed [Ah 9d] and won (353) with a straight, Six to Ten



PokerStars Game #14415194893: Tournament #999999999, 1FPP Hold'em No Limit - Level III (100/200) - 2010/06/04 19:54:54 WET [2010/06/04 14:54:54 ET]
Table '999999998 11' 6-max Seat #4 is the button
Seat 1: Player6 (600 in chips) 
Seat 2: Player21 (1920 in chips) 
Seat 3: Player16 (3020 in chips) 
Seat 4: Player11 (354 in chips) 
Seat 5: Hero (8148 in chips) 
Seat 6: Player7 (353 in chips) 
Player6: posts the ante 40
Player21: posts the ante 40
Player16: posts the ante 40
Player11: posts the ante 40
Hero: posts the ante 40
Player7: posts the ante 40
Hero: posts small blind 100
Player7: posts big blind 200
*** HOLE CARDS ***
Dealt to Hero [Ks 4c]
Player6 said, "dikhead"
Player6: folds 
Hero said, "chatban"
Player21: folds 
Player16: raises 200 to 400
Player11: calls 314 and is all-in
Hero: calls 300
Player7: calls 113 and is all-in
*** FLOP *** [9c 5d 2d]
Hero: checks 
Player16: checks 
*** TURN *** [9c 5d 2d] [Kh]
Hero: checks 
Player16: checks 
*** RIVER *** [9c 5d 2d Kh] [9d]
Hero: checks 
Player16: checks 
*** SHOW DOWN ***
Hero: shows [Ks 4c] (two pair, Kings and Nines)
Player16: mucks hand 
Hero collected 172 from side pot-2 
Player11: mucks hand 
Player6 said, "cok face dip shiit"
Hero collected 3 from side pot-1 
Player7: mucks hand 
Hero collected 1492 from main pot
Player7 re-buys and receives 600 chips for 2 FPPs
Player11 re-buys and receives 600 chips for 2 FPPs
*** SUMMARY ***
Total pot 1667 Main pot 1492. Side pot-1 3. Side pot-2 172. | Rake 0 
Board [9c 5d 2d Kh 9d]
Seat 1: Player6 folded before Flop (didn't bet)
Seat 2: Player21 folded before Flop (didn't bet)
Seat 3: Player16 mucked [Ad 5c]
Seat 4: Player11 (button) mucked [4h 4d]
Seat 5: Hero (small blind) showed [Ks 4c] and won (1667) with two pair, Kings and Nines
Seat 6: Player7 (big blind) mucked [Qh 2s]



PokerStars Game #48839292212: Tournament #999999999, 1FPP Hold'em No Limit - Level IV (200/400) - 2010/06/04 19:55:58 WET [2010/06/04 14:55:58 ET]
Table '999999998 11' 6-max Seat #5 is the button
Seat 1: Player6 (560 in chips) 
Seat 2: Player21 (1880 in chips) 
Seat 3: Player16 (2580 in chips) 
Seat 4: Player11 (600 in chips) 
Seat 5: Hero (9375 in chips) 
Seat 6: Player7 (600 in chips) 
Player6: posts the ante 80
Player21: posts the ante 80
Player16: posts the ante 80
Player11: posts the ante 80
Hero: posts the ante 80
Player7: posts the ante 80
Player7: posts small blind 200
Player6: posts big blind 400
*** HOLE CARDS ***
Dealt to Hero [As Ad]
Hero said, "chatban"
Player21: raises 1400 to 1800 and is all-in
Player16: folds 
Player11: calls 520 and is all-in
Hero: raises 7495 to 9295 and is all-in
Player7: calls 320 and is all-in
Player6: calls 80 and is all-in
Uncalled bet (7495) returned to Hero
*** FLOP *** [6h 8d 2c]
*** TURN *** [6h 8d 2c] [8s]
Player11 is disconnected 
*** RIVER *** [6h 8d 2c 8s] [8h]
*** SHOW DOWN ***
Player21: shows [5d 5s] (a full house, Eights full of Fives)
Hero: shows [As Ad] (a full house, Eights full of Aces)
Player6 said, "cok face dik sucker"
Hero collected 2560 from side pot-2 
Player7: shows [3h Jh] (three of a kind, Eights)
Player11: shows [5h Kd] (three of a kind, Eights)
Hero collected 160 from side pot-1 
Player6: shows [3d Tc] (three of a kind, Eights)
Hero collected 2880 from main pot
Player6 said, "cok head"
Player7 re-buys and receives 600 chips for 2 FPPs
Hero said, "lol"
Player6 said, "dik"
Player6 said, "dik"
Player6 said, "dik"
Hero said, "tilt"
Player6 said, "dikd"
Player6 said, "idk"
Player6 said, "dik"
Player6 said, "dik"
Hero said, "tilt"
Player6 said, "dik"
Hero said, "tilt"
Player6 said, "dik"
Player6 said, "dik"
Player6 said, "dik"
Hero said, "hahahahaha"
Player6 said, "dik"
Player6 said, "dio"
Player11 has timed out while disconnected
Player21 re-buys and receives 600 chips for 2 FPPs
Player6 re-buys and receives 300 chips for 1 FPPs
Player11 finished the tournament in 185th place
*** SUMMARY ***
Total pot 5600 Main pot 2880. Side pot-1 160. Side pot-2 2560. | Rake 0 
Board [6h 8d 2c 8s 8h]
Seat 1: Player6 (big blind) showed [3d Tc] and lost with three of a kind, Eights
Seat 2: Player21 showed [5d 5s] and lost with a full house, Eights full of Fives
Seat 3: Player16 folded before Flop (didn't bet)
Seat 4: Player11 showed [5h Kd] and lost with three of a kind, Eights
Seat 5: Hero (button) showed [As Ad] and won (5600) with a full house, Eights full of Aces
Seat 6: Player7 (small blind) showed [3h Jh] and lost with three of a kind, Eights



PokerStars Game #15911190352: Tournament #999999999, 1FPP Hold'em No Limit - Level IV (200/400) - 2010/06/04 19:57:01 WET [2010/06/04 14:57:01 ET]
Table '999999998 11' 6-max Seat #6 is the button
Seat 1: Player6 (300 in chips) 
Seat 2: Player21 (600 in chips) 
Seat 3: Player16 (2500 in chips) 
Seat 5: Hero (13095 in chips) 
Seat 6: Player7 (600 in chips) 
Player6: posts the ante 80
Player21: posts the ante 80
Player16: posts the ante 80
Hero: posts the ante 80
Player7: posts the ante 80
Player6: posts small blind 200
Player21: posts big blind 400
*** HOLE CARDS ***
Dealt to Hero [3s 4d]
Player16: folds 
Hero: raises 400 to 800
Player7: folds 
Player6: calls 20 and is all-in
Player21: calls 120 and is all-in
Uncalled bet (280) returned to Hero
*** FLOP *** [Kh Jc 7c]
*** TURN *** [Kh Jc 7c] [Kd]
*** RIVER *** [Kh Jc 7c Kd] [3c]
*** SHOW DOWN ***
Player21: shows [5h Qc] (a pair of Kings)
Hero: shows [3s 4d] (two pair, Kings and Threes)
Player1 is connected 
Player6 said, "haha dik"
Hero collected 600 from side pot
Player6: shows [4s 7d] (two pair, Kings and Sevens)
Player6 collected 1060 from main pot
Player21 re-buys and receives 600 chips for 2 FPPs
Player6 said, "dik head"
*** SUMMARY ***
Total pot 1660 Main pot 1060. Side pot 600. | Rake 0 
Board [Kh Jc 7c Kd 3c]
Seat 1: Player6 (small blind) showed [4s 7d] and won (1060) with two pair, Kings and Sevens
Seat 2: Player21 (big blind) showed [5h Qc] and lost with a pair of Kings
Seat 3: Player16 folded before Flop (didn't bet)
Seat 5: Hero showed [3s 4d] and won (600) with two pair, Kings and Threes
Seat 6: Player7 (button) folded before Flop (didn't bet)



PokerStars Game #31048178850: Tournament #999999999, 1FPP Hold'em No Limit - Level IV (200/400) - 2010/06/04 19:57:38 WET [2010/06/04 14:57:38 ET]
Table '999999998 11' 6-max Seat #1 is the button
Seat 1: Player6 (1060 in chips) 
Seat 2: Player21 (600 in chips) 
Seat 3: Player16 (2420 in chips) 
Seat 4: Player1 (600 in chips) 
Seat 5: Hero (13095 in chips) 
Seat 6: Player7 (520 in chips) 
Player6: posts the ante 80
Player21: posts the ante 80
Player16: posts the ante 80
Player1: posts the ante 80
Hero: posts the ante 80
Player7: posts the ante 80
Player21: posts small blind 200
Player16: posts big blind 400
*** HOLE CARDS ***
Dealt to Hero [5d 6c]
Hero said, "hahahaha"
Player1: raises 120 to 520 and is all-in
Hero: calls 520
Player7: calls 440 and is all-in
Player6: folds 
Player21: calls 320 and is all-in
Player16: calls 120
*** FLOP *** [8d 8c 7d]
Player16: checks 
Hero: checks 
*** TURN *** [8d 8c 7d] [Qd]
Player16: checks 
Hero: checks 
*** RIVER *** [8d 8c 7d Qd] [Ah]
Player16: checks 
Hero: checks 
*** SHOW DOWN ***
Player21: shows [Th Ts] (two pair, Tens and Eights)
Player16: mucks hand 
Player1: mucks hand 
Hero: mucks hand 
Player21 collected 320 from side pot
Player7: shows [Td Qc] (two pair, Queens and Eights)
Player6 said, "dik"
Player7 collected 2680 from main pot
Player1 re-buys and receives 600 chips for 2 FPPs
*** SUMMARY ***
Total pot 3000 Main pot 2680. Side pot 320. | Rake 0 
Board [8d 8c 7d Qd Ah]
Seat 1: Player6 (button) folded before Flop (didn't bet)
Seat 2: Player21 (small blind) showed [Th Ts] and won (320) with two pair, Tens and Eights
Seat 3: Player16 (big blind) mucked [Js 2c]
Seat 4: Player1 mucked [2h 9d]
Seat 5: Hero mucked [5d 6c]
Seat 6: Player7 showed [Td Qc] and won (2680) with two pair, Queens and Eights



PokerStars Game #61011805711: Tournament #999999999, 1FPP Hold'em No Limit - Level V (300/600) - 2010/06/04 19:59:10 WET [2010/06/04 14:59:10 ET]
Table '999999998 11' 6-max Seat #2 is the button
Seat 1: Player6 (980 in chips) 
Seat 2: Player21 (320 in chips) 
Seat 3: Player16 (1820 in chips) 
Seat 4: Player1 (600 in chips) 
Seat 5: Hero (12495 in chips) 
Seat 6: Player7 (2680 in chips) 
Player6: posts the ante 120
Player21: posts the ante 120
Player16: posts the ante 120
Player1: posts the ante 120
Hero: posts the ante 120
Player7: posts the ante 120
Player16: posts small blind 300
Player1: posts big blind 480 and is all-in
*** HOLE CARDS ***
Dealt to Hero [2c 9h]
Hero: folds 
Player7: folds 
Player6: raises 380 to 860 and is all-in
Player21: folds 
Player16: calls 560
*** FLOP *** [Kd 7c Ad]
Player6 said, "bye dik head"
*** TURN *** [Kd 7c Ad] [4d]
*** RIVER *** [Kd 7c Ad 4d] [6d]
*** SHOW DOWN ***
Player16: shows [Jh 3h] (high card Ace)
Player6: shows [Jc 9c] (high card Ace - King+Jack+Nine kicker)
Player6 collected 760 from side pot
Player1: shows [Js 7h] (a pair of Sevens)
Player1 collected 2160 from main pot
*** SUMMARY ***
Total pot 2920 Main pot 2160. Side pot 760. | Rake 0 
Board [Kd 7c Ad 4d 6d]
Seat 1: Player6 showed [Jc 9c] and won (760) with high card Ace
Seat 2: Player21 (button) folded before Flop (didn't bet)
Seat 3: Player16 (small blind) showed [Jh 3h] and lost with high card Ace
Seat 4: Player1 (big blind) showed [Js 7h] and won (2160) with a pair of Sevens
Seat 5: Hero folded before Flop (didn't bet)
Seat 6: Player7 folded before Flop (didn't bet)



PokerStars Game #41541235827: Tournament #999999999, 1FPP Hold'em No Limit - Level V (300/600) - 2010/06/04 19:59:40 WET [2010/06/04 14:59:40 ET]
Table '999999998 11' 6-max Seat #3 is the button
Seat 1: Player6 (760 in chips) 
Seat 2: Player21 (200 in chips) 
Seat 3: Player16 (840 in chips) 
Seat 4: Player1 (2160 in chips) 
Seat 5: Hero (12375 in chips) 
Seat 6: Player7 (2560 in chips) 
Player6: posts the ante 120
Player21: posts the ante 120
Player16: posts the ante 120
Player1: posts the ante 120
Hero: posts the ante 120
Player7: posts the ante 120
Player1: posts small blind 300
Hero: posts big blind 600
*** HOLE CARDS ***
Dealt to Hero [2d 4h]
Player7: folds 
Player6 said, "dik face"
Player6: raises 40 to 640 and is all-in
Player21: calls 80 and is all-in
Player16: folds 
Player1: folds 
Hero: calls 40
*** FLOP *** [5h 4d 9h]
Player6 said, "bye dumb shiiit"
*** TURN *** [5h 4d 9h] [6d]
*** RIVER *** [5h 4d 9h 6d] [Jd]
*** SHOW DOWN ***
Hero: shows [2d 4h] (a pair of Fours)
Player6: shows [Jc Ad] (a pair of Jacks)
Player6 collected 1340 from side pot
Player21: shows [7h 7d] (a pair of Sevens)
Player6 collected 1040 from main pot
Player6 said, "ok"
Player21 re-buys and receives 600 chips for 2 FPPs
Player6 said, "not yet"
*** SUMMARY ***
Total pot 2380 Main pot 1040. Side pot 1340. | Rake 0 
Board [5h 4d 9h 6d Jd]
Seat 1: Player6 showed [Jc Ad] and won (2380) with a pair of Jacks
Seat 2: Player21 showed [7h 7d] and lost with a pair of Sevens
Seat 3: Player16 (button) folded before Flop (didn't bet)
Seat 4: Player1 (small blind) folded before Flop
Seat 5: Hero (big blind) showed [2d 4h] and lost with a pair of Fours
Seat 6: Player7 folded before Flop (didn't bet)



PokerStars Game #27976721395: Tournament #999999999, 1FPP Hold'em No Limit - Level V (300/600) - 2010/06/04 20:00:16 WET [2010/06/04 15:00:16 ET]
Table '999999998 11' 6-max Seat #4 is the button
Seat 1: Player6 (2380 in chips) 
Seat 2: Player21 (600 in chips) 
Seat 3: Player16 (720 in chips) 
Seat 4: Player1 (1740 in chips) 
Seat 5: Hero (11615 in chips) 
Seat 6: Player7 (2440 in chips) 
Player6: posts the ante 120
Player21: posts the ante 120
Player16: posts the ante 120
Player1: posts the ante 120
Hero: posts the ante 120
Player7: posts the ante 120
Hero: posts small blind 300
Player7: posts big blind 600
*** HOLE CARDS ***
Dealt to Hero [Jd Js]
Player6: raises 1660 to 2260 and is all-in
Player21: folds 
Player16: calls 600 and is all-in
Player1: calls 1620 and is all-in
Hero: calls 1960
Player7: folds 
*** FLOP *** [Kc 8d Qh]
Player6 said, "comn dik face omg ur so **** dik heads"
*** TURN *** [Kc 8d Qh] [5s]
*** RIVER *** [Kc 8d Qh 5s] [9s]
*** SHOW DOWN ***
Hero: shows [Jd Js] (a pair of Jacks)
Player6: shows [4c 4s] (a pair of Fours)
Hero collected 1280 from side pot-2 
Player1: shows [As 4d] (high card Ace)
Hero collected 3060 from side pot-1 
Player16: shows [Td Ks] (a pair of Kings)
Player6 said, "bye **** head"
Player16 collected 3720 from main pot
Hero said, "byebye"
Player1 re-buys and receives 600 chips for 2 FPPs
Player6 finished the tournament in 155th place
*** SUMMARY ***
Total pot 8060 Main pot 3720. Side pot-1 3060. Side pot-2 1280. | Rake 0 
Board [Kc 8d Qh 5s 9s]
Seat 1: Player6 showed [4c 4s] and lost with a pair of Fours
Seat 2: Player21 folded before Flop (didn't bet)
Seat 3: Player16 showed [Td Ks] and won (3720) with a pair of Kings
Seat 4: Player1 (button) showed [As 4d] and lost with high card Ace
Seat 5: Hero (small blind) showed [Jd Js] and won (4340) with a pair of Jacks
Seat 6: Player7 (big blind) folded before Flop



PokerStars Game #25234313412: Tournament #999999999, 1FPP Hold'em No Limit - Level V (300/600) - 2010/06/04 20:01:02 WET [2010/06/04 15:01:02 ET]
Table '999999998 11' 6-max Seat #5 is the button
Seat 2: Player21 (480 in chips) 
Seat 3: Player16 (3720 in chips) 
Seat 4: Player1 (600 in chips) 
Seat 5: Hero (13575 in chips) 
Seat 6: Player7 (1720 in chips) 
Player21: posts the ante 120
Player16: posts the ante 120
Player1: posts the ante 120
Hero: posts the ante 120
Player7: posts the ante 120
Player7: posts small blind 300
Player21: posts big blind 360 and is all-in
*** HOLE CARDS ***
Dealt to Hero [Qh 3s]
Player16: folds 
Player1: calls 480 and is all-in
Hero: folds 
Player7: calls 180
*** FLOP *** [8h 5c 3d]
*** TURN *** [8h 5c 3d] [7d]
*** RIVER *** [8h 5c 3d 7d] [2s]
*** SHOW DOWN ***
Player7: shows [9s Ac] (high card Ace)
Player1: shows [5h Qs] (a pair of Fives)
Player1 collected 240 from side pot
Player21: shows [6c Ks] (high card King)
Player1 collected 1680 from main pot
Player5 is connected 
Player21 finished the tournament in 148th place
*** SUMMARY ***
Total pot 1920 Main pot 1680. Side pot 240. | Rake 0 
Board [8h 5c 3d 7d 2s]
Seat 2: Player21 (big blind) showed [6c Ks] and lost with high card King
Seat 3: Player16 folded before Flop (didn't bet)
Seat 4: Player1 showed [5h Qs] and won (1920) with a pair of Fives
Seat 5: Hero (button) folded before Flop (didn't bet)
Seat 6: Player7 (small blind) showed [9s Ac] and lost with high card Ace



PokerStars Game #95143913174: Tournament #999999999, 1FPP Hold'em No Limit - Level VI (400/800) - 2010/06/04 20:03:37 WET [2010/06/04 15:03:37 ET]
Table '999999998 11' 6-max Seat #6 is the button
Seat 1: Player5 (1940 in chips) out of hand (moved from another table into small blind)
Seat 2: Player4 (3540 in chips) out of hand (moved from another table into small blind)
Seat 3: Player16 (4100 in chips) 
Seat 4: Player1 (2420 in chips) 
Seat 5: Hero (13955 in chips) 
Seat 6: Player7 (1620 in chips) 
Player16: posts the ante 160
Player1: posts the ante 160
Hero: posts the ante 160
Player7: posts the ante 160
Player16: posts small blind 400
Player1: posts big blind 800
*** HOLE CARDS ***
Dealt to Hero [Qs 4h]
Hero: folds 
Player7: folds 
Player16: raises 3140 to 3940 and is all-in
Player1: calls 1460 and is all-in
Uncalled bet (1680) returned to Player16
*** FLOP *** [2d 7c Jh]
*** TURN *** [2d 7c Jh] [3c]
*** RIVER *** [2d 7c Jh 3c] [5h]
*** SHOW DOWN ***
Player16: shows [Ah Kh] (high card Ace)
Player1: shows [Tc 5s] (a pair of Fives)
Player1 collected 5160 from pot
*** SUMMARY ***
Total pot 5160 | Rake 0 
Board [2d 7c Jh 3c 5h]
Seat 3: Player16 (small blind) showed [Ah Kh] and lost with high card Ace
Seat 4: Player1 (big blind) showed [Tc 5s] and won (5160) with a pair of Fives
Seat 5: Hero folded before Flop (didn't bet)
Seat 6: Player7 (button) folded before Flop (didn't bet)



PokerStars Game #50411262384: Tournament #999999999, 1FPP Hold'em No Limit - Level VI (400/800) - 2010/06/04 20:04:15 WET [2010/06/04 15:04:15 ET]
Table '999999998 11' 6-max Seat #3 is the button
Seat 1: Player5 (1940 in chips) 
Seat 2: Player4 (3540 in chips) 
Seat 3: Player16 (1680 in chips) 
Seat 4: Player1 (5160 in chips) 
Seat 5: Hero (13795 in chips) 
Seat 6: Player7 (1460 in chips) 
Player5: posts the ante 160
Player4: posts the ante 160
Player16: posts the ante 160
Player1: posts the ante 160
Hero: posts the ante 160
Player7: posts the ante 160
Player1: posts small blind 400
Hero: posts big blind 800
*** HOLE CARDS ***
Dealt to Hero [Ac Th]
Player7: folds 
Player5: folds 
Player4: folds 
Player16: raises 720 to 1520 and is all-in
Player1: raises 3480 to 5000 and is all-in
Hero: folds 
Uncalled bet (3480) returned to Player1
*** FLOP *** [4s 3c Kc]
*** TURN *** [4s 3c Kc] [7s]
*** RIVER *** [4s 3c Kc 7s] [9s]
*** SHOW DOWN ***
Player1: shows [Qs Kh] (a pair of Kings)
Player16: shows [9d Qc] (a pair of Nines)
Player1 collected 4800 from pot
Player16 finished the tournament in 120th place
*** SUMMARY ***
Total pot 4800 | Rake 0 
Board [4s 3c Kc 7s 9s]
Seat 1: Player5 folded before Flop (didn't bet)
Seat 2: Player4 folded before Flop (didn't bet)
Seat 3: Player16 (button) showed [9d Qc] and lost with a pair of Nines
Seat 4: Player1 (small blind) showed [Qs Kh] and won (4800) with a pair of Kings
Seat 5: Hero (big blind) folded before Flop
Seat 6: Player7 folded before Flop (didn't bet)



PokerStars Game #16124236191: Tournament #999999999, 1FPP Hold'em No Limit - Level VI (400/800) - 2010/06/04 20:04:51 WET [2010/06/04 15:04:51 ET]
Table '999999998 11' 6-max Seat #4 is the button
Seat 1: Player5 (1780 in chips) 
Seat 2: Player4 (3380 in chips) 
Seat 4: Player1 (8280 in chips) 
Seat 5: Hero (12835 in chips) 
Seat 6: Player7 (1300 in chips) 
Player5: posts the ante 160
Player4: posts the ante 160
Player1: posts the ante 160
Hero: posts the ante 160
Player7: posts the ante 160
Hero: posts small blind 400
Player7: posts big blind 800
*** HOLE CARDS ***
Dealt to Hero [9d 7d]
Player5: folds 
Player4: folds 
Player1: calls 800
Player9 is connected 
Hero: calls 400
Player7: checks 
*** FLOP *** [Tc Qd 9c]
Hero: checks 
Player7: bets 340 and is all-in
Player1: calls 340
Hero: calls 340
*** TURN *** [Tc Qd 9c] [Td]
Hero: checks 
Player1: checks 
*** RIVER *** [Tc Qd 9c Td] [Jh]
Hero: checks 
Player1: bets 2400
Hero: folds 
Uncalled bet (2400) returned to Player1
*** SHOW DOWN ***
Player1: shows [6c 8d] (a straight, Eight to Queen)
Player7: shows [Jc 8c] (a straight, Eight to Queen)
Player7 collected 2110 from pot
Player1 collected 2110 from pot
*** SUMMARY ***
Total pot 4220 | Rake 0 
Board [Tc Qd 9c Td Jh]
Seat 1: Player5 folded before Flop (didn't bet)
Seat 2: Player4 folded before Flop (didn't bet)
Seat 4: Player1 (button) showed [6c 8d] and won (2110) with a straight, Eight to Queen
Seat 5: Hero (small blind) folded on the River
Seat 6: Player7 (big blind) showed [Jc 8c] and won (2110) with a straight, Eight to Queen



PokerStars Game #20501244423: Tournament #999999999, 1FPP Hold'em No Limit - Level VI (400/800) - 2010/06/04 20:05:47 WET [2010/06/04 15:05:47 ET]
Table '999999998 11' 6-max Seat #5 is the button
Seat 1: Player5 (1620 in chips) 
Seat 2: Player4 (3220 in chips) 
Seat 3: Player9 (3065 in chips) 
Seat 4: Player1 (9090 in chips) 
Seat 5: Hero (11535 in chips) 
Seat 6: Player7 (2110 in chips) 
Player5: posts the ante 160
Player4: posts the ante 160
Player9: posts the ante 160
Player1: posts the ante 160
Hero: posts the ante 160
Player7: posts the ante 160
Player7: posts small blind 400
Player5: posts big blind 800
*** HOLE CARDS ***
Dealt to Hero [3c Kd]
Player4: folds 
Player9: folds 
Player1: folds 
Hero: folds 
Player7: folds 
Uncalled bet (400) returned to Player5
Player5 collected 1760 from pot
*** SUMMARY ***
Total pot 1760 | Rake 0 
Seat 1: Player5 (big blind) collected (1760)
Seat 2: Player4 folded before Flop (didn't bet)
Seat 3: Player9 folded before Flop (didn't bet)
Seat 4: Player1 folded before Flop (didn't bet)
Seat 5: Hero (button) folded before Flop (didn't bet)
Seat 6: Player7 (small blind) folded before Flop



PokerStars Game #18390596592: Tournament #999999999, 1FPP Hold'em No Limit - Level VI (400/800) - 2010/06/04 20:06:03 WET [2010/06/04 15:06:03 ET]
Table '999999998 11' 6-max Seat #6 is the button
Seat 1: Player5 (2820 in chips) 
Seat 2: Player4 (3060 in chips) 
Seat 3: Player9 (2905 in chips) 
Seat 4: Player1 (8930 in chips) 
Seat 5: Hero (11375 in chips) 
Seat 6: Player7 (1550 in chips) 
Player5: posts the ante 160
Player4: posts the ante 160
Player9: posts the ante 160
Player1: posts the ante 160
Hero: posts the ante 160
Player7: posts the ante 160
Player5: posts small blind 400
Player4: posts big blind 800
*** HOLE CARDS ***
Dealt to Hero [2h Qc]
Player9: folds 
Player1: folds 
Hero: folds 
Player7: folds 
Player5: calls 400
Player4: checks 
*** FLOP *** [9c 6d Td]
Player5: checks 
Player4: checks 
*** TURN *** [9c 6d Td] [4d]
Player5: checks 
Player4: bets 2100 and is all-in
Player5: folds 
Uncalled bet (2100) returned to Player4
Player4 collected 2560 from pot
Player4: doesn't show hand 
*** SUMMARY ***
Total pot 2560 | Rake 0 
Board [9c 6d Td 4d]
Seat 1: Player5 (small blind) folded on the Turn
Seat 2: Player4 (big blind) collected (2560)
Seat 3: Player9 folded before Flop (didn't bet)
Seat 4: Player1 folded before Flop (didn't bet)
Seat 5: Hero folded before Flop (didn't bet)
Seat 6: Player7 (button) folded before Flop (didn't bet)



PokerStars Game #52768090525: Tournament #999999999, 1FPP Hold'em No Limit - Level VI (400/800) - 2010/06/04 20:06:35 WET [2010/06/04 15:06:35 ET]
Table '999999998 11' 6-max Seat #1 is the button
Seat 1: Player5 (1860 in chips) 
Seat 2: Player4 (4660 in chips) 
Seat 3: Player9 (2745 in chips) 
Seat 4: Player1 (8770 in chips) 
Seat 5: Hero (11215 in chips) 
Seat 6: Player7 (1390 in chips) 
Player5: posts the ante 160
Player4: posts the ante 160
Player9: posts the ante 160
Player1: posts the ante 160
Hero: posts the ante 160
Player7: posts the ante 160
Player4: posts small blind 400
Player9: posts big blind 800
*** HOLE CARDS ***
Dealt to Hero [3s 3c]
Player1: raises 4800 to 5600
Hero: folds 
Player7: folds 
Player5: folds 
Player4: folds 
Player9: folds 
Uncalled bet (4800) returned to Player1
Player1 collected 2960 from pot
*** SUMMARY ***
Total pot 2960 | Rake 0 
Seat 1: Player5 (button) folded before Flop (didn't bet)
Seat 2: Player4 (small blind) folded before Flop
Seat 3: Player9 (big blind) folded before Flop
Seat 4: Player1 collected (2960)
Seat 5: Hero folded before Flop (didn't bet)
Seat 6: Player7 folded before Flop (didn't bet)



PokerStars Game #23011819420: Tournament #999999999, 1FPP Hold'em No Limit - Level VII (600/1200) - 2010/06/04 20:06:55 WET [2010/06/04 15:06:55 ET]
Table '999999998 11' 6-max Seat #2 is the button
Seat 1: Player5 (1700 in chips) 
Seat 2: Player4 (4100 in chips) 
Seat 3: Player9 (1785 in chips) 
Seat 4: Player1 (10770 in chips) 
Seat 5: Hero (11055 in chips) 
Seat 6: Player7 (1230 in chips) 
Player5: posts the ante 240
Player4: posts the ante 240
Player9: posts the ante 240
Player1: posts the ante 240
Hero: posts the ante 240
Player7: posts the ante 240
Player9: posts small blind 600
Player1: posts big blind 1200
*** HOLE CARDS ***
Dealt to Hero [2c 6d]
Hero: folds 
Player7: calls 990 and is all-in
Player5: raises 260 to 1460 and is all-in
Player4: folds 
Player9: folds 
Player1: calls 260
*** FLOP *** [Ts 7d Js]
*** TURN *** [Ts 7d Js] [4c]
*** RIVER *** [Ts 7d Js 4c] [3d]
*** SHOW DOWN ***
Player1: shows [2h 9s] (high card Jack)
Player5: shows [Jc Jd] (three of a kind, Jacks)
Player5 collected 940 from side pot
Player7: shows [4d Ac] (a pair of Fours)
Player5 collected 5010 from main pot
*** SUMMARY ***
Total pot 5950 Main pot 5010. Side pot 940. | Rake 0 
Board [Ts 7d Js 4c 3d]
Seat 1: Player5 showed [Jc Jd] and won (5950) with three of a kind, Jacks
Seat 2: Player4 (button) folded before Flop (didn't bet)
Seat 3: Player9 (small blind) folded before Flop
Seat 4: Player1 (big blind) showed [2h 9s] and lost with high card Jack
Seat 5: Hero folded before Flop (didn't bet)
Seat 6: Player7 showed [4d Ac] and lost with a pair of Fours



PokerStars Game #24661247813: Tournament #999999999, 1FPP Hold'em No Limit - Level VII (600/1200) - 2010/06/04 20:07:27 WET [2010/06/04 15:07:27 ET]
Table '999999998 48' 6-max Seat #1 is the button
Seat 1: Player17 (14798 in chips) 
Seat 2: Player3 (7215 in chips) 
Seat 3: Player15 (6378 in chips) 
Seat 4: Hero (10815 in chips) 
Seat 5: Player2 (8520 in chips) 
Seat 6: Player22 (11935 in chips) 
Player17: posts the ante 240
Player3: posts the ante 240
Player15: posts the ante 240
Hero: posts the ante 240
Player2: posts the ante 240
Player22: posts the ante 240
Player3: posts small blind 600
Player15: posts big blind 1200
*** HOLE CARDS ***
Dealt to Hero [2s Td]
Hero: folds 
Player2: raises 7080 to 8280 and is all-in
Player22: calls 8280
Player17: folds 
Player3: folds 
Player15: calls 4938 and is all-in
*** FLOP *** [Ac Th 9d]
*** TURN *** [Ac Th 9d] [3c]
*** RIVER *** [Ac Th 9d 3c] [4d]
*** SHOW DOWN ***
Player2: shows [Kd 5s] (high card Ace)
Player22: shows [2c Ah] (a pair of Aces)
Player22 collected 4284 from side pot
Player15: shows [7d 7c] (a pair of Sevens)
Player22 collected 20454 from main pot
Player2 finished the tournament in 74th place
Player15 finished the tournament in 75th place
*** SUMMARY ***
Total pot 24738 Main pot 20454. Side pot 4284. | Rake 0 
Board [Ac Th 9d 3c 4d]
Seat 1: Player17 (button) folded before Flop (didn't bet)
Seat 2: Player3 (small blind) folded before Flop
Seat 3: Player15 (big blind) showed [7d 7c] and lost with a pair of Sevens
Seat 4: Hero folded before Flop (didn't bet)
Seat 5: Player2 showed [Kd 5s] and lost with high card Ace
Seat 6: Player22 showed [2c Ah] and won (24738) with a pair of Aces



PokerStars Game #28167203221: Tournament #999999999, 1FPP Hold'em No Limit - Level VII (600/1200) - 2010/06/04 20:07:59 WET [2010/06/04 15:07:59 ET]
Table '999999998 48' 6-max Seat #2 is the button
Seat 1: Player17 (14558 in chips) 
Seat 2: Player3 (6375 in chips) 
Seat 4: Hero (10575 in chips) 
Seat 6: Player22 (28153 in chips) 
Player17: posts the ante 240
Player3: posts the ante 240
Hero: posts the ante 240
Player22: posts the ante 240
Hero: posts small blind 600
Player22: posts big blind 1200
*** HOLE CARDS ***
Dealt to Hero [6h Jd]
Player17: folds 
Player3: raises 4935 to 6135 and is all-in
Hero: folds 
Player19 is connected 
Player22: calls 4935
Player10 is connected 
*** FLOP *** [2s Kh 9s]
*** TURN *** [2s Kh 9s] [Kc]
*** RIVER *** [2s Kh 9s Kc] [3c]
*** SHOW DOWN ***
Player22: shows [Ah Tc] (a pair of Kings)
Player3: shows [5h As] (a pair of Kings - lower kicker)
Player22 collected 13830 from pot
Player3 finished the tournament in 70th place
*** SUMMARY ***
Total pot 13830 | Rake 0 
Board [2s Kh 9s Kc 3c]
Seat 1: Player17 folded before Flop (didn't bet)
Seat 2: Player3 (button) showed [5h As] and lost with a pair of Kings
Seat 4: Hero (small blind) folded before Flop
Seat 6: Player22 (big blind) showed [Ah Tc] and won (13830) with a pair of Kings



PokerStars Game #30715143285: Tournament #999999999, 1FPP Hold'em No Limit - Level VII (600/1200) - 2010/06/04 20:08:26 WET [2010/06/04 15:08:26 ET]
Table '999999998 48' 6-max Seat #4 is the button
Seat 1: Player17 (14318 in chips) 
Seat 3: Player19 (1508 in chips) 
Seat 4: Hero (9735 in chips) 
Seat 5: Player10 (5690 in chips) out of hand (moved from another table into small blind)
Seat 6: Player22 (35608 in chips) 
Player17: posts the ante 240
Player19: posts the ante 240
Hero: posts the ante 240
Player22: posts the ante 240
Player22: posts small blind 600
Player17: posts big blind 1200
*** HOLE CARDS ***
Dealt to Hero [2s Ac]
Player19: folds 
Hero: raises 8295 to 9495 and is all-in
Player22: folds 
Player17: calls 8295
*** FLOP *** [Kc 5d 3d]
*** TURN *** [Kc 5d 3d] [6c]
*** RIVER *** [Kc 5d 3d 6c] [Ad]
*** SHOW DOWN ***
Player17: shows [Jh Qd] (high card Ace)
Hero: shows [2s Ac] (a pair of Aces)
Hero collected 20550 from pot
*** SUMMARY ***
Total pot 20550 | Rake 0 
Board [Kc 5d 3d 6c Ad]
Seat 1: Player17 (big blind) showed [Jh Qd] and lost with high card Ace
Seat 3: Player19 folded before Flop (didn't bet)
Seat 4: Hero (button) showed [2s Ac] and won (20550) with a pair of Aces
Seat 6: Player22 (small blind) folded before Flop



PokerStars Game #16429177523: Tournament #999999999, 1FPP Hold'em No Limit - Level VII (600/1200) - 2010/06/04 20:08:51 WET [2010/06/04 15:08:51 ET]
Table '999999998 48' 6-max Seat #6 is the button
Seat 1: Player17 (4583 in chips) 
Seat 3: Player19 (1268 in chips) 
Seat 4: Hero (20550 in chips) 
Seat 5: Player10 (5690 in chips) 
Seat 6: Player22 (34768 in chips) 
Player17: posts the ante 240
Player19: posts the ante 240
Hero: posts the ante 240
Player10: posts the ante 240
Player22: posts the ante 240
Player17: posts small blind 600
Player19: posts big blind 1028 and is all-in
*** HOLE CARDS ***
Dealt to Hero [3d 6c]
Hero: folds 
Player10: folds 
Player22: raises 1372 to 2400
Player17: calls 1800
*** FLOP *** [9c 4s Ac]
Player17: checks 
Player22: bets 1200
Player17: folds 
Uncalled bet (1200) returned to Player22
*** TURN *** [9c 4s Ac] [Kc]
*** RIVER *** [9c 4s Ac Kc] [Qs]
*** SHOW DOWN ***
Player22: shows [Jd Qd] (a pair of Queens)
Player22 collected 2744 from side pot
Player19: shows [7s 4c] (a pair of Fours)
Player22 collected 4284 from main pot
*** SUMMARY ***
Total pot 7028 Main pot 4284. Side pot 2744. | Rake 0 
Board [9c 4s Ac Kc Qs]
Seat 1: Player17 (small blind) folded on the Flop
Seat 3: Player19 (big blind) showed [7s 4c] and lost with a pair of Fours
Seat 4: Hero folded before Flop (didn't bet)
Seat 5: Player10 folded before Flop (didn't bet)
Seat 6: Player22 (button) showed [Jd Qd] and won (7028) with a pair of Queens



PokerStars Game #14176179211: Tournament #999999999, 1FPP Hold'em No Limit - Level VII (600/1200) - 2010/06/04 20:09:27 WET [2010/06/04 15:09:27 ET]
Table '999999998 5' 6-max Seat #4 is the button
Seat 1: Player14 (5780 in chips) 
Seat 2: Player17 (1943 in chips) 
Seat 3: Hero (20310 in chips) 
Seat 4: Player20 (23421 in chips) 
Seat 5: Player8 (19258 in chips) 
Seat 6: Player23 (26326 in chips) 
Player14: posts the ante 240
Player17: posts the ante 240
Hero: posts the ante 240
Player20: posts the ante 240
Player8: posts the ante 240
Player23: posts the ante 240
Player8: posts small blind 600
Player23: posts big blind 1200
*** HOLE CARDS ***
Dealt to Hero [7d As]
Player14: folds 
Player17: folds 
Hero: raises 18000 to 19200
Player20: raises 3981 to 23181 and is all-in
Player8: folds 
Player23: folds 
Hero: calls 870 and is all-in
Uncalled bet (3111) returned to Player20
*** FLOP *** [7h 4h 3s]
*** TURN *** [7h 4h 3s] [Th]
*** RIVER *** [7h 4h 3s Th] [Ah]
*** SHOW DOWN ***
Hero: shows [7d As] (two pair, Aces and Sevens)
Player20: shows [Ad Kh] (a flush, Ace high)
Player20 collected 43380 from pot
Hero finished the tournament in 54th place
*** SUMMARY ***
Total pot 43380 | Rake 0 
Board [7h 4h 3s Th Ah]
Seat 1: Player14 folded before Flop (didn't bet)
Seat 2: Player17 folded before Flop (didn't bet)
Seat 3: Hero showed [7d As] and lost with two pair, Aces and Sevens
Seat 4: Player20 (button) showed [Ad Kh] and won (43380) with a flush, Ace high
Seat 5: Player8 (small blind) folded before Flop
Seat 6: Player23 (big blind) folded before Flop




