PokerStars Game #62678213223: Tournament #999999999, $20.00+$0.80 USD Hold'em No Limit - Level I (10/20) - 2010/06/05 18:20:59 WET [2010/06/05 13:20:59 ET]
Table '999999993 1' 10-max Seat #1 is the button
Seat 1: Player7 (1500 in chips) 
Seat 2: Player1 (1500 in chips) 
Seat 3: Player3 (1500 in chips) 
Seat 4: Player4 (1500 in chips) 
Seat 5: Player5 (1500 in chips) 
Seat 6: Player2 (1500 in chips) 
Seat 7: Player6 (1500 in chips) 
Seat 8: Hero (1500 in chips) 
Seat 9: Player9 (1500 in chips) 
Seat 10: Player8 (1500 in chips) 
Player1: posts small blind 10
Player3: posts big blind 20
*** HOLE CARDS ***
Dealt to Hero [4c 7d]
Player4: folds 
Player5: folds 
Player2: folds 
Player6: folds 
Hero: folds 
Player9: folds 
Player8: folds 
Player7: folds 
Player1: folds 
Uncalled bet (10) returned to Player3
Player3 collected 20 from pot
Player3: doesn't show hand 
*** SUMMARY ***
Total pot 20 | Rake 0 
Seat 1: Player7 (button) folded before Flop (didn't bet)
Seat 2: Player1 (small blind) folded before Flop
Seat 3: Player3 (big blind) collected (20)
Seat 4: Player4 folded before Flop (didn't bet)
Seat 5: Player5 folded before Flop (didn't bet)
Seat 6: Player2 folded before Flop (didn't bet)
Seat 7: Player6 folded before Flop (didn't bet)
Seat 8: Hero folded before Flop (didn't bet)
Seat 9: Player9 folded before Flop (didn't bet)
Seat 10: Player8 folded before Flop (didn't bet)



PokerStars Game #32163049071: Tournament #999999999, $20.00+$0.80 USD Hold'em No Limit - Level I (10/20) - 2010/06/05 18:21:28 WET [2010/06/05 13:21:28 ET]
Table '999999993 1' 10-max Seat #2 is the button
Seat 1: Player7 (1500 in chips) 
Seat 2: Player1 (1490 in chips) 
Seat 3: Player3 (1510 in chips) 
Seat 4: Player4 (1500 in chips) 
Seat 5: Player5 (1500 in chips) 
Seat 6: Player2 (1500 in chips) 
Seat 7: Player6 (1500 in chips) 
Seat 8: Hero (1500 in chips) 
Seat 9: Player9 (1500 in chips) 
Seat 10: Player8 (1500 in chips) 
Player3: posts small blind 10
Player4: posts big blind 20
*** HOLE CARDS ***
Dealt to Hero [8h Jh]
Player5: folds 
Player2: folds 
Player6: folds 
Hero: raises 40 to 60
Player9: folds 
Player8: folds 
Player7: folds 
Player1: calls 60
Player3: folds 
Player4: folds 
*** FLOP *** [2h 7c Th]
Hero: bets 80
Player1: calls 80
*** TURN *** [2h 7c Th] [5s]
Hero: checks 
Player1: bets 217
Hero: calls 217
*** RIVER *** [2h 7c Th 5s] [Jd]
Hero: checks 
Player1: checks 
*** SHOW DOWN ***
Hero: shows [8h Jh] (a pair of Jacks)
Player1: mucks hand 
Hero collected 744 from pot
*** SUMMARY ***
Total pot 744 | Rake 0 
Board [2h 7c Th 5s Jd]
Seat 1: Player7 folded before Flop (didn't bet)
Seat 2: Player1 (button) mucked [9c 9s]
Seat 3: Player3 (small blind) folded before Flop
Seat 4: Player4 (big blind) folded before Flop
Seat 5: Player5 folded before Flop (didn't bet)
Seat 6: Player2 folded before Flop (didn't bet)
Seat 7: Player6 folded before Flop (didn't bet)
Seat 8: Hero showed [8h Jh] and won (744) with a pair of Jacks
Seat 9: Player9 folded before Flop (didn't bet)
Seat 10: Player8 folded before Flop (didn't bet)



PokerStars Game #32288202831: Tournament #999999999, $20.00+$0.80 USD Hold'em No Limit - Level I (10/20) - 2010/06/05 18:22:27 WET [2010/06/05 13:22:27 ET]
Table '999999993 1' 10-max Seat #3 is the button
Seat 1: Player7 (1500 in chips) 
Seat 2: Player1 (1133 in chips) 
Seat 3: Player3 (1500 in chips) 
Seat 4: Player4 (1480 in chips) 
Seat 5: Player5 (1500 in chips) 
Seat 6: Player2 (1500 in chips) 
Seat 7: Player6 (1500 in chips) 
Seat 8: Hero (1887 in chips) 
Seat 9: Player9 (1500 in chips) 
Seat 10: Player8 (1500 in chips) 
Player4: posts small blind 10
Player5: posts big blind 20
*** HOLE CARDS ***
Dealt to Hero [Ks 8s]
Player2: folds 
Player6: folds 
Hero: folds 
Player9: calls 20
Player8: folds 
Player7: folds 
Player1: folds 
Player3: raises 60 to 80
Player4: folds 
Player5: folds 
Player9: folds 
Uncalled bet (60) returned to Player3
Player3 collected 70 from pot
Player3: doesn't show hand 
*** SUMMARY ***
Total pot 70 | Rake 0 
Seat 1: Player7 folded before Flop (didn't bet)
Seat 2: Player1 folded before Flop (didn't bet)
Seat 3: Player3 (button) collected (70)
Seat 4: Player4 (small blind) folded before Flop
Seat 5: Player5 (big blind) folded before Flop
Seat 6: Player2 folded before Flop (didn't bet)
Seat 7: Player6 folded before Flop (didn't bet)
Seat 8: Hero folded before Flop (didn't bet)
Seat 9: Player9 folded before Flop
Seat 10: Player8 folded before Flop (didn't bet)



PokerStars Game #42832402272: Tournament #999999999, $20.00+$0.80 USD Hold'em No Limit - Level I (10/20) - 2010/06/05 18:23:00 WET [2010/06/05 13:23:00 ET]
Table '999999993 1' 10-max Seat #4 is the button
Seat 1: Player7 (1500 in chips) 
Seat 2: Player1 (1133 in chips) 
Seat 3: Player3 (1550 in chips) 
Seat 4: Player4 (1470 in chips) 
Seat 5: Player5 (1480 in chips) 
Seat 6: Player2 (1500 in chips) 
Seat 7: Player6 (1500 in chips) 
Seat 8: Hero (1887 in chips) 
Seat 9: Player9 (1480 in chips) 
Seat 10: Player8 (1500 in chips) 
Player5: posts small blind 10
Player2: posts big blind 20
*** HOLE CARDS ***
Dealt to Hero [7c 5c]
Player6: folds 
Hero: folds 
Player9: calls 20
Player8: folds 
Player7: folds 
Player1: folds 
Player3: raises 60 to 80
Player4: folds 
Player5: folds 
Player2: folds 
Player9: calls 60
*** FLOP *** [Ks Qc Td]
Player9: bets 80
Player3: folds 
Uncalled bet (80) returned to Player9
Player9 collected 190 from pot
*** SUMMARY ***
Total pot 190 | Rake 0 
Board [Ks Qc Td]
Seat 1: Player7 folded before Flop (didn't bet)
Seat 2: Player1 folded before Flop (didn't bet)
Seat 3: Player3 folded on the Flop
Seat 4: Player4 (button) folded before Flop (didn't bet)
Seat 5: Player5 (small blind) folded before Flop
Seat 6: Player2 (big blind) folded before Flop
Seat 7: Player6 folded before Flop (didn't bet)
Seat 8: Hero folded before Flop (didn't bet)
Seat 9: Player9 collected (190)
Seat 10: Player8 folded before Flop (didn't bet)



PokerStars Game #23213683913: Tournament #999999999, $20.00+$0.80 USD Hold'em No Limit - Level I (10/20) - 2010/06/05 18:23:43 WET [2010/06/05 13:23:43 ET]
Table '999999993 1' 10-max Seat #5 is the button
Seat 1: Player7 (1500 in chips) 
Seat 2: Player1 (1133 in chips) 
Seat 3: Player3 (1470 in chips) 
Seat 4: Player4 (1470 in chips) 
Seat 5: Player5 (1470 in chips) 
Seat 6: Player2 (1480 in chips) 
Seat 7: Player6 (1500 in chips) 
Seat 8: Hero (1887 in chips) 
Seat 9: Player9 (1590 in chips) 
Seat 10: Player8 (1500 in chips) 
Player2: posts small blind 10
Player6: posts big blind 20
*** HOLE CARDS ***
Dealt to Hero [Jh Qc]
Hero: folds 
Player9: raises 40 to 60
Player8: folds 
Player7: folds 
Player1: folds 
Player3: raises 100 to 160
Player4: folds 
Player5: folds 
Player2: folds 
Player6: folds 
Player9: calls 100
*** FLOP *** [8h Qd Js]
Player9: bets 160
Player3: raises 160 to 320
Player9: raises 280 to 600
Player3: raises 710 to 1310 and is all-in
Player9: calls 710
*** TURN *** [8h Qd Js] [8s]
*** RIVER *** [8h Qd Js 8s] [2h]
*** SHOW DOWN ***
Player9: shows [Qs Kd] (two pair, Queens and Eights)
Player3: shows [Kc Ks] (two pair, Kings and Eights)
Player3 collected 2970 from pot
*** SUMMARY ***
Total pot 2970 | Rake 0 
Board [8h Qd Js 8s 2h]
Seat 1: Player7 folded before Flop (didn't bet)
Seat 2: Player1 folded before Flop (didn't bet)
Seat 3: Player3 showed [Kc Ks] and won (2970) with two pair, Kings and Eights
Seat 4: Player4 folded before Flop (didn't bet)
Seat 5: Player5 (button) folded before Flop (didn't bet)
Seat 6: Player2 (small blind) folded before Flop
Seat 7: Player6 (big blind) folded before Flop
Seat 8: Hero folded before Flop (didn't bet)
Seat 9: Player9 showed [Qs Kd] and lost with two pair, Queens and Eights
Seat 10: Player8 folded before Flop (didn't bet)



PokerStars Game #63032690445: Tournament #999999999, $20.00+$0.80 USD Hold'em No Limit - Level I (10/20) - 2010/06/05 18:24:42 WET [2010/06/05 13:24:42 ET]
Table '999999993 1' 10-max Seat #6 is the button
Seat 1: Player7 (1500 in chips) 
Seat 2: Player1 (1133 in chips) 
Seat 3: Player3 (2970 in chips) 
Seat 4: Player4 (1470 in chips) 
Seat 5: Player5 (1470 in chips) 
Seat 6: Player2 (1470 in chips) 
Seat 7: Player6 (1480 in chips) 
Seat 8: Hero (1887 in chips) 
Seat 9: Player9 (120 in chips) 
Seat 10: Player8 (1500 in chips) 
Player6: posts small blind 10
Hero: posts big blind 20
*** HOLE CARDS ***
Dealt to Hero [7h 8c]
Player9: raises 100 to 120 and is all-in
Player8: folds 
Player7: folds 
Player1: folds 
Player3: folds 
Player4: folds 
Player5: folds 
Player2: folds 
Player6: folds 
Hero: calls 100
*** FLOP *** [4h 9h 3s]
*** TURN *** [4h 9h 3s] [Ks]
*** RIVER *** [4h 9h 3s Ks] [9s]
*** SHOW DOWN ***
Hero: shows [7h 8c] (a pair of Nines)
Player9: shows [2d 2c] (two pair, Nines and Deuces)
Player9 collected 250 from pot
*** SUMMARY ***
Total pot 250 | Rake 0 
Board [4h 9h 3s Ks 9s]
Seat 1: Player7 folded before Flop (didn't bet)
Seat 2: Player1 folded before Flop (didn't bet)
Seat 3: Player3 folded before Flop (didn't bet)
Seat 4: Player4 folded before Flop (didn't bet)
Seat 5: Player5 folded before Flop (didn't bet)
Seat 6: Player2 (button) folded before Flop (didn't bet)
Seat 7: Player6 (small blind) folded before Flop
Seat 8: Hero (big blind) showed [7h 8c] and lost with a pair of Nines
Seat 9: Player9 showed [2d 2c] and won (250) with two pair, Nines and Deuces
Seat 10: Player8 folded before Flop (didn't bet)



PokerStars Game #26424166162: Tournament #999999999, $20.00+$0.80 USD Hold'em No Limit - Level I (10/20) - 2010/06/05 18:25:40 WET [2010/06/05 13:25:40 ET]
Table '999999993 1' 10-max Seat #7 is the button
Seat 1: Player7 (1500 in chips) 
Seat 2: Player1 (1133 in chips) 
Seat 3: Player3 (2970 in chips) 
Seat 4: Player4 (1470 in chips) 
Seat 5: Player5 (1470 in chips) 
Seat 6: Player2 (1470 in chips) 
Seat 7: Player6 (1470 in chips) 
Seat 8: Hero (1767 in chips) 
Seat 9: Player9 (250 in chips) 
Seat 10: Player8 (1500 in chips) 
Hero: posts small blind 10
Player9: posts big blind 20
*** HOLE CARDS ***
Dealt to Hero [2d 4s]
Player8: folds 
Player7: folds 
Player1: folds 
Player3: raises 60 to 80
Player4: calls 80
Player5: folds 
Player2: folds 
Player6: calls 80
Hero: folds 
Player9: folds 
*** FLOP *** [Ks 8s 8c]
Player3: checks 
Player4: checks 
Player6: checks 
*** TURN *** [Ks 8s 8c] [2c]
Player3: checks 
Player4: checks 
Player6: bets 140
Player3: folds 
Player4: folds 
Uncalled bet (140) returned to Player6
Player6 collected 270 from pot
*** SUMMARY ***
Total pot 270 | Rake 0 
Board [Ks 8s 8c 2c]
Seat 1: Player7 folded before Flop (didn't bet)
Seat 2: Player1 folded before Flop (didn't bet)
Seat 3: Player3 folded on the Turn
Seat 4: Player4 folded on the Turn
Seat 5: Player5 folded before Flop (didn't bet)
Seat 6: Player2 folded before Flop (didn't bet)
Seat 7: Player6 (button) collected (270)
Seat 8: Hero (small blind) folded before Flop
Seat 9: Player9 (big blind) folded before Flop
Seat 10: Player8 folded before Flop (didn't bet)



PokerStars Game #17689229111: Tournament #999999999, $20.00+$0.80 USD Hold'em No Limit - Level II (15/30) - 2010/06/05 18:26:52 WET [2010/06/05 13:26:52 ET]
Table '999999993 1' 10-max Seat #8 is the button
Seat 1: Player7 (1500 in chips) 
Seat 2: Player1 (1133 in chips) 
Seat 3: Player3 (2890 in chips) 
Seat 4: Player4 (1390 in chips) 
Seat 5: Player5 (1470 in chips) 
Seat 6: Player2 (1470 in chips) 
Seat 7: Player6 (1660 in chips) 
Seat 8: Hero (1757 in chips) 
Seat 9: Player9 (230 in chips) 
Seat 10: Player8 (1500 in chips) 
Player9: posts small blind 15
Player8: posts big blind 30
*** HOLE CARDS ***
Dealt to Hero [Th Kd]
Player7: folds 
Player1: folds 
Player3: raises 90 to 120
Player4: folds 
Player5: folds 
Player2: folds 
Player6: folds 
Hero: folds 
Player9: raises 110 to 230 and is all-in
Player8: folds 
Player3: calls 110
*** FLOP *** [5s 5d 6s]
*** TURN *** [5s 5d 6s] [Qs]
*** RIVER *** [5s 5d 6s Qs] [Jc]
*** SHOW DOWN ***
Player9: shows [Ks 8d] (a pair of Fives)
Player3: shows [Ac Qc] (two pair, Queens and Fives)
Player3 collected 490 from pot
Player9 finished the tournament in 10th place
*** SUMMARY ***
Total pot 490 | Rake 0 
Board [5s 5d 6s Qs Jc]
Seat 1: Player7 folded before Flop (didn't bet)
Seat 2: Player1 folded before Flop (didn't bet)
Seat 3: Player3 showed [Ac Qc] and won (490) with two pair, Queens and Fives
Seat 4: Player4 folded before Flop (didn't bet)
Seat 5: Player5 folded before Flop (didn't bet)
Seat 6: Player2 folded before Flop (didn't bet)
Seat 7: Player6 folded before Flop (didn't bet)
Seat 8: Hero (button) folded before Flop (didn't bet)
Seat 9: Player9 (small blind) showed [Ks 8d] and lost with a pair of Fives
Seat 10: Player8 (big blind) folded before Flop



PokerStars Game #24859173248: Tournament #999999999, $20.00+$0.80 USD Hold'em No Limit - Level II (15/30) - 2010/06/05 18:27:52 WET [2010/06/05 13:27:52 ET]
Table '999999993 1' 10-max Seat #10 is the button
Seat 1: Player7 (1500 in chips) 
Seat 2: Player1 (1133 in chips) 
Seat 3: Player3 (3150 in chips) 
Seat 4: Player4 (1390 in chips) 
Seat 5: Player5 (1470 in chips) 
Seat 6: Player2 (1470 in chips) 
Seat 7: Player6 (1660 in chips) 
Seat 8: Hero (1757 in chips) 
Seat 10: Player8 (1470 in chips) 
Player7: posts small blind 15
Player1: posts big blind 30
*** HOLE CARDS ***
Dealt to Hero [Ah Td]
Player3: folds 
Player4: folds 
Player5: folds 
Player2: folds 
Player6: folds 
Hero: raises 90 to 120
Player8: folds 
Player7: folds 
Player1: folds 
Uncalled bet (90) returned to Hero
Hero collected 75 from pot
Hero: doesn't show hand 
*** SUMMARY ***
Total pot 75 | Rake 0 
Seat 1: Player7 (small blind) folded before Flop
Seat 2: Player1 (big blind) folded before Flop
Seat 3: Player3 folded before Flop (didn't bet)
Seat 4: Player4 folded before Flop (didn't bet)
Seat 5: Player5 folded before Flop (didn't bet)
Seat 6: Player2 folded before Flop (didn't bet)
Seat 7: Player6 folded before Flop (didn't bet)
Seat 8: Hero collected (75)
Seat 10: Player8 (button) folded before Flop (didn't bet)



PokerStars Game #23369170253: Tournament #999999999, $20.00+$0.80 USD Hold'em No Limit - Level II (15/30) - 2010/06/05 18:28:38 WET [2010/06/05 13:28:38 ET]
Table '999999993 1' 10-max Seat #1 is the button
Seat 1: Player7 (1485 in chips) 
Seat 2: Player1 (1103 in chips) 
Seat 3: Player3 (3150 in chips) 
Seat 4: Player4 (1390 in chips) 
Seat 5: Player5 (1470 in chips) 
Seat 6: Player2 (1470 in chips) 
Seat 7: Player6 (1660 in chips) 
Seat 8: Hero (1802 in chips) 
Seat 10: Player8 (1470 in chips) 
Player1: posts small blind 15
Player3: posts big blind 30
*** HOLE CARDS ***
Dealt to Hero [Js Qs]
Player4: folds 
Player5: folds 
Player2: raises 30 to 60
Player6: folds 
Hero: folds 
Player8: folds 
Player7: folds 
Player1: calls 45
Player3: folds 
*** FLOP *** [2d 7d 4s]
Player1: bets 120
Player2: raises 150 to 270
Player1: calls 150
*** TURN *** [2d 7d 4s] [3c]
Player1: checks 
Player2: checks 
*** RIVER *** [2d 7d 4s 3c] [5d]
Player1: bets 773 and is all-in
Player2: folds 
Uncalled bet (773) returned to Player1
Player1 collected 690 from pot
*** SUMMARY ***
Total pot 690 | Rake 0 
Board [2d 7d 4s 3c 5d]
Seat 1: Player7 (button) folded before Flop (didn't bet)
Seat 2: Player1 (small blind) collected (690)
Seat 3: Player3 (big blind) folded before Flop
Seat 4: Player4 folded before Flop (didn't bet)
Seat 5: Player5 folded before Flop (didn't bet)
Seat 6: Player2 folded on the River
Seat 7: Player6 folded before Flop (didn't bet)
Seat 8: Hero folded before Flop (didn't bet)
Seat 10: Player8 folded before Flop (didn't bet)



PokerStars Game #10078346175: Tournament #999999999, $20.00+$0.80 USD Hold'em No Limit - Level II (15/30) - 2010/06/05 18:29:47 WET [2010/06/05 13:29:47 ET]
Table '999999993 1' 10-max Seat #2 is the button
Seat 1: Player7 (1485 in chips) 
Seat 2: Player1 (1463 in chips) 
Seat 3: Player3 (3120 in chips) 
Seat 4: Player4 (1390 in chips) 
Seat 5: Player5 (1470 in chips) 
Seat 6: Player2 (1140 in chips) 
Seat 7: Player6 (1660 in chips) 
Seat 8: Hero (1802 in chips) 
Seat 10: Player8 (1470 in chips) 
Player3: posts small blind 15
Player4: posts big blind 30
*** HOLE CARDS ***
Dealt to Hero [6h Kc]
Player5: folds 
Player2: folds 
Player6: folds 
Hero: folds 
Player8: folds 
Player7: folds 
Player1: folds 
Player3: folds 
Uncalled bet (15) returned to Player4
Player4 collected 30 from pot
*** SUMMARY ***
Total pot 30 | Rake 0 
Seat 1: Player7 folded before Flop (didn't bet)
Seat 2: Player1 (button) folded before Flop (didn't bet)
Seat 3: Player3 (small blind) folded before Flop
Seat 4: Player4 (big blind) collected (30)
Seat 5: Player5 folded before Flop (didn't bet)
Seat 6: Player2 folded before Flop (didn't bet)
Seat 7: Player6 folded before Flop (didn't bet)
Seat 8: Hero folded before Flop (didn't bet)
Seat 10: Player8 folded before Flop (didn't bet)



PokerStars Game #14493477081: Tournament #999999999, $20.00+$0.80 USD Hold'em No Limit - Level II (15/30) - 2010/06/05 18:30:22 WET [2010/06/05 13:30:22 ET]
Table '999999993 1' 10-max Seat #3 is the button
Seat 1: Player7 (1485 in chips) 
Seat 2: Player1 (1463 in chips) 
Seat 3: Player3 (3105 in chips) 
Seat 4: Player4 (1405 in chips) 
Seat 5: Player5 (1470 in chips) 
Seat 6: Player2 (1140 in chips) 
Seat 7: Player6 (1660 in chips) 
Seat 8: Hero (1802 in chips) 
Seat 10: Player8 (1470 in chips) 
Player4: posts small blind 15
Player5: posts big blind 30
*** HOLE CARDS ***
Dealt to Hero [Td 9c]
Player2: raises 60 to 90
Player6: folds 
Hero: folds 
Player8: folds 
Player7: folds 
Player1: folds 
Player3: folds 
Player4: folds 
Player5: folds 
Uncalled bet (60) returned to Player2
Player2 collected 75 from pot
Player2: doesn't show hand 
*** SUMMARY ***
Total pot 75 | Rake 0 
Seat 1: Player7 folded before Flop (didn't bet)
Seat 2: Player1 folded before Flop (didn't bet)
Seat 3: Player3 (button) folded before Flop (didn't bet)
Seat 4: Player4 (small blind) folded before Flop
Seat 5: Player5 (big blind) folded before Flop
Seat 6: Player2 collected (75)
Seat 7: Player6 folded before Flop (didn't bet)
Seat 8: Hero folded before Flop (didn't bet)
Seat 10: Player8 folded before Flop (didn't bet)



PokerStars Game #17974129386: Tournament #999999999, $20.00+$0.80 USD Hold'em No Limit - Level II (15/30) - 2010/06/05 18:30:59 WET [2010/06/05 13:30:59 ET]
Table '999999993 1' 10-max Seat #4 is the button
Seat 1: Player7 (1485 in chips) 
Seat 2: Player1 (1463 in chips) 
Seat 3: Player3 (3105 in chips) 
Seat 4: Player4 (1390 in chips) 
Seat 5: Player5 (1440 in chips) 
Seat 6: Player2 (1185 in chips) 
Seat 7: Player6 (1660 in chips) 
Seat 8: Hero (1802 in chips) 
Seat 10: Player8 (1470 in chips) 
Player5: posts small blind 15
Player2: posts big blind 30
*** HOLE CARDS ***
Dealt to Hero [4c Ts]
Player6: folds 
Hero: folds 
Player8: folds 
Player7: folds 
Player1: folds 
Player3: folds 
Player4: folds 
Player5: folds 
Uncalled bet (15) returned to Player2
Player2 collected 30 from pot
Player2: doesn't show hand 
*** SUMMARY ***
Total pot 30 | Rake 0 
Seat 1: Player7 folded before Flop (didn't bet)
Seat 2: Player1 folded before Flop (didn't bet)
Seat 3: Player3 folded before Flop (didn't bet)
Seat 4: Player4 (button) folded before Flop (didn't bet)
Seat 5: Player5 (small blind) folded before Flop
Seat 6: Player2 (big blind) collected (30)
Seat 7: Player6 folded before Flop (didn't bet)
Seat 8: Hero folded before Flop (didn't bet)
Seat 10: Player8 folded before Flop (didn't bet)



PokerStars Game #21963114551: Tournament #999999999, $20.00+$0.80 USD Hold'em No Limit - Level III (25/50) - 2010/06/05 18:31:32 WET [2010/06/05 13:31:32 ET]
Table '999999993 1' 10-max Seat #5 is the button
Seat 1: Player7 (1485 in chips) 
Seat 2: Player1 (1463 in chips) 
Seat 3: Player3 (3105 in chips) 
Seat 4: Player4 (1390 in chips) 
Seat 5: Player5 (1425 in chips) 
Seat 6: Player2 (1200 in chips) 
Seat 7: Player6 (1660 in chips) 
Seat 8: Hero (1802 in chips) 
Seat 10: Player8 (1470 in chips) 
Player7: posts the ante 5
Player1: posts the ante 5
Player3: posts the ante 5
Player4: posts the ante 5
Player5: posts the ante 5
Player2: posts the ante 5
Player6: posts the ante 5
Hero: posts the ante 5
Player8: posts the ante 5
Player2: posts small blind 25
Player6: posts big blind 50
*** HOLE CARDS ***
Dealt to Hero [3c Th]
Hero: folds 
Player8: folds 
Player7: folds 
Player1: folds 
Player3: raises 3050 to 3100 and is all-in
Player4: folds 
Player5: folds 
Player2: folds 
Player6: folds 
Uncalled bet (3050) returned to Player3
Player3 collected 170 from pot
Player3: doesn't show hand 
*** SUMMARY ***
Total pot 170 | Rake 0 
Seat 1: Player7 folded before Flop (didn't bet)
Seat 2: Player1 folded before Flop (didn't bet)
Seat 3: Player3 collected (170)
Seat 4: Player4 folded before Flop (didn't bet)
Seat 5: Player5 (button) folded before Flop (didn't bet)
Seat 6: Player2 (small blind) folded before Flop
Seat 7: Player6 (big blind) folded before Flop
Seat 8: Hero folded before Flop (didn't bet)
Seat 10: Player8 folded before Flop (didn't bet)



PokerStars Game #67720495136: Tournament #999999999, $20.00+$0.80 USD Hold'em No Limit - Level III (25/50) - 2010/06/05 18:32:17 WET [2010/06/05 13:32:17 ET]
Table '999999993 1' 10-max Seat #6 is the button
Seat 1: Player7 (1480 in chips) 
Seat 2: Player1 (1458 in chips) 
Seat 3: Player3 (3220 in chips) 
Seat 4: Player4 (1385 in chips) 
Seat 5: Player5 (1420 in chips) 
Seat 6: Player2 (1170 in chips) 
Seat 7: Player6 (1605 in chips) 
Seat 8: Hero (1797 in chips) 
Seat 10: Player8 (1465 in chips) 
Player7: posts the ante 5
Player1: posts the ante 5
Player3: posts the ante 5
Player4: posts the ante 5
Player5: posts the ante 5
Player2: posts the ante 5
Player6: posts the ante 5
Hero: posts the ante 5
Player8: posts the ante 5
Player6: posts small blind 25
Hero: posts big blind 50
*** HOLE CARDS ***
Dealt to Hero [Ad 3h]
Player8: folds 
Player7: folds 
Player1: folds 
Player3: folds 
Player4: raises 150 to 200
Player5: folds 
Player2: folds 
Player6: folds 
Hero: folds 
Uncalled bet (150) returned to Player4
Player4 collected 170 from pot
Player4: shows [Th Td] (a pair of Tens)
*** SUMMARY ***
Total pot 170 | Rake 0 
Seat 1: Player7 folded before Flop (didn't bet)
Seat 2: Player1 folded before Flop (didn't bet)
Seat 3: Player3 folded before Flop (didn't bet)
Seat 4: Player4 collected (170)
Seat 5: Player5 folded before Flop (didn't bet)
Seat 6: Player2 (button) folded before Flop (didn't bet)
Seat 7: Player6 (small blind) folded before Flop
Seat 8: Hero (big blind) folded before Flop
Seat 10: Player8 folded before Flop (didn't bet)



PokerStars Game #82492925521: Tournament #999999999, $20.00+$0.80 USD Hold'em No Limit - Level III (25/50) - 2010/06/05 18:33:16 WET [2010/06/05 13:33:16 ET]
Table '999999993 1' 10-max Seat #7 is the button
Seat 1: Player7 (1475 in chips) 
Seat 2: Player1 (1453 in chips) 
Seat 3: Player3 (3215 in chips) 
Seat 4: Player4 (1500 in chips) 
Seat 5: Player5 (1415 in chips) 
Seat 6: Player2 (1165 in chips) 
Seat 7: Player6 (1575 in chips) 
Seat 8: Hero (1742 in chips) 
Seat 10: Player8 (1460 in chips) 
Player7: posts the ante 5
Player1: posts the ante 5
Player3: posts the ante 5
Player4: posts the ante 5
Player5: posts the ante 5
Player2: posts the ante 5
Player6: posts the ante 5
Hero: posts the ante 5
Player8: posts the ante 5
Hero: posts small blind 25
Player8: posts big blind 50
*** HOLE CARDS ***
Dealt to Hero [4c 3d]
Player7: folds 
Player1: folds 
Player3: raises 50 to 100
Player4: folds 
Player5: folds 
Player2: folds 
Player6: calls 100
Hero: folds 
Player8: folds 
*** FLOP *** [As 7h Td]
Player3: bets 3110 and is all-in
Player6: folds 
Uncalled bet (3110) returned to Player3
Player3 collected 320 from pot
Player3: doesn't show hand 
*** SUMMARY ***
Total pot 320 | Rake 0 
Board [As 7h Td]
Seat 1: Player7 folded before Flop (didn't bet)
Seat 2: Player1 folded before Flop (didn't bet)
Seat 3: Player3 collected (320)
Seat 4: Player4 folded before Flop (didn't bet)
Seat 5: Player5 folded before Flop (didn't bet)
Seat 6: Player2 folded before Flop (didn't bet)
Seat 7: Player6 (button) folded on the Flop
Seat 8: Hero (small blind) folded before Flop
Seat 10: Player8 (big blind) folded before Flop



PokerStars Game #21093287397: Tournament #999999999, $20.00+$0.80 USD Hold'em No Limit - Level III (25/50) - 2010/06/05 18:34:10 WET [2010/06/05 13:34:10 ET]
Table '999999993 1' 10-max Seat #8 is the button
Seat 1: Player7 (1470 in chips) 
Seat 2: Player1 (1448 in chips) 
Seat 3: Player3 (3430 in chips) 
Seat 4: Player4 (1495 in chips) 
Seat 5: Player5 (1410 in chips) 
Seat 6: Player2 (1160 in chips) 
Seat 7: Player6 (1470 in chips) 
Seat 8: Hero (1712 in chips) 
Seat 10: Player8 (1405 in chips) 
Player7: posts the ante 5
Player1: posts the ante 5
Player3: posts the ante 5
Player4: posts the ante 5
Player5: posts the ante 5
Player2: posts the ante 5
Player6: posts the ante 5
Hero: posts the ante 5
Player8: posts the ante 5
Player8: posts small blind 25
Player7: posts big blind 50
*** HOLE CARDS ***
Dealt to Hero [Js Qd]
Player1: folds 
Player3: raises 50 to 100
Player4: folds 
Player5: folds 
Player2: folds 
Player6: folds 
Hero: folds 
Player8: folds 
Player7: folds 
Uncalled bet (50) returned to Player3
Player3 collected 170 from pot
Player3: doesn't show hand 
*** SUMMARY ***
Total pot 170 | Rake 0 
Seat 1: Player7 (big blind) folded before Flop
Seat 2: Player1 folded before Flop (didn't bet)
Seat 3: Player3 collected (170)
Seat 4: Player4 folded before Flop (didn't bet)
Seat 5: Player5 folded before Flop (didn't bet)
Seat 6: Player2 folded before Flop (didn't bet)
Seat 7: Player6 folded before Flop (didn't bet)
Seat 8: Hero (button) folded before Flop (didn't bet)
Seat 10: Player8 (small blind) folded before Flop



PokerStars Game #71563601774: Tournament #999999999, $20.00+$0.80 USD Hold'em No Limit - Level III (25/50) - 2010/06/05 18:34:40 WET [2010/06/05 13:34:40 ET]
Table '999999993 1' 10-max Seat #10 is the button
Seat 1: Player7 (1415 in chips) 
Seat 2: Player1 (1443 in chips) 
Seat 3: Player3 (3545 in chips) 
Seat 4: Player4 (1490 in chips) 
Seat 5: Player5 (1405 in chips) 
Seat 6: Player2 (1155 in chips) 
Seat 7: Player6 (1465 in chips) 
Seat 8: Hero (1707 in chips) 
Seat 10: Player8 (1375 in chips) 
Player7: posts the ante 5
Player1: posts the ante 5
Player3: posts the ante 5
Player4: posts the ante 5
Player5: posts the ante 5
Player2: posts the ante 5
Player6: posts the ante 5
Hero: posts the ante 5
Player8: posts the ante 5
Player7: posts small blind 25
Player1: posts big blind 50
*** HOLE CARDS ***
Dealt to Hero [4h Qh]
Player3: folds 
Player4: folds 
Player5: folds 
Player2: folds 
Player6: folds 
Hero: folds 
Player8: raises 100 to 150
Player7: folds 
Player1: folds 
Uncalled bet (100) returned to Player8
Player8 collected 170 from pot
Player8: doesn't show hand 
*** SUMMARY ***
Total pot 170 | Rake 0 
Seat 1: Player7 (small blind) folded before Flop
Seat 2: Player1 (big blind) folded before Flop
Seat 3: Player3 folded before Flop (didn't bet)
Seat 4: Player4 folded before Flop (didn't bet)
Seat 5: Player5 folded before Flop (didn't bet)
Seat 6: Player2 folded before Flop (didn't bet)
Seat 7: Player6 folded before Flop (didn't bet)
Seat 8: Hero folded before Flop (didn't bet)
Seat 10: Player8 (button) collected (170)



PokerStars Game #28530256453: Tournament #999999999, $20.00+$0.80 USD Hold'em No Limit - Level III (25/50) - 2010/06/05 18:35:15 WET [2010/06/05 13:35:15 ET]
Table '999999993 1' 10-max Seat #1 is the button
Seat 1: Player7 (1385 in chips) 
Seat 2: Player1 (1388 in chips) 
Seat 3: Player3 (3540 in chips) 
Seat 4: Player4 (1485 in chips) 
Seat 5: Player5 (1400 in chips) 
Seat 6: Player2 (1150 in chips) 
Seat 7: Player6 (1460 in chips) 
Seat 8: Hero (1702 in chips) 
Seat 10: Player8 (1490 in chips) 
Player7: posts the ante 5
Player1: posts the ante 5
Player3: posts the ante 5
Player4: posts the ante 5
Player5: posts the ante 5
Player2: posts the ante 5
Player6: posts the ante 5
Hero: posts the ante 5
Player8: posts the ante 5
Player1: posts small blind 25
Player3: posts big blind 50
*** HOLE CARDS ***
Dealt to Hero [Td 7c]
Player4: folds 
Player5: folds 
Player2: folds 
Player6: folds 
Hero: folds 
Player8: folds 
Player7: folds 
Player1: folds 
Uncalled bet (25) returned to Player3
Player3 collected 95 from pot
Player3: doesn't show hand 
*** SUMMARY ***
Total pot 95 | Rake 0 
Seat 1: Player7 (button) folded before Flop (didn't bet)
Seat 2: Player1 (small blind) folded before Flop
Seat 3: Player3 (big blind) collected (95)
Seat 4: Player4 folded before Flop (didn't bet)
Seat 5: Player5 folded before Flop (didn't bet)
Seat 6: Player2 folded before Flop (didn't bet)
Seat 7: Player6 folded before Flop (didn't bet)
Seat 8: Hero folded before Flop (didn't bet)
Seat 10: Player8 folded before Flop (didn't bet)



PokerStars Game #30086223433: Tournament #999999999, $20.00+$0.80 USD Hold'em No Limit - Level III (25/50) - 2010/06/05 18:35:54 WET [2010/06/05 13:35:54 ET]
Table '999999993 1' 10-max Seat #2 is the button
Seat 1: Player7 (1380 in chips) 
Seat 2: Player1 (1358 in chips) 
Seat 3: Player3 (3605 in chips) 
Seat 4: Player4 (1480 in chips) 
Seat 5: Player5 (1395 in chips) 
Seat 6: Player2 (1145 in chips) 
Seat 7: Player6 (1455 in chips) 
Seat 8: Hero (1697 in chips) 
Seat 10: Player8 (1485 in chips) 
Player7: posts the ante 5
Player1: posts the ante 5
Player3: posts the ante 5
Player4: posts the ante 5
Player5: posts the ante 5
Player2: posts the ante 5
Player6: posts the ante 5
Hero: posts the ante 5
Player8: posts the ante 5
Player3: posts small blind 25
Player4: posts big blind 50
*** HOLE CARDS ***
Dealt to Hero [8s 7h]
Player5: raises 100 to 150
Player2: folds 
Player6: folds 
Hero: folds 
Player8: folds 
Player7: folds 
Player1: folds 
Player3: folds 
Player4: folds 
Uncalled bet (100) returned to Player5
Player5 collected 170 from pot
Player5: doesn't show hand 
*** SUMMARY ***
Total pot 170 | Rake 0 
Seat 1: Player7 folded before Flop (didn't bet)
Seat 2: Player1 (button) folded before Flop (didn't bet)
Seat 3: Player3 (small blind) folded before Flop
Seat 4: Player4 (big blind) folded before Flop
Seat 5: Player5 collected (170)
Seat 6: Player2 folded before Flop (didn't bet)
Seat 7: Player6 folded before Flop (didn't bet)
Seat 8: Hero folded before Flop (didn't bet)
Seat 10: Player8 folded before Flop (didn't bet)



PokerStars Game #24072342623: Tournament #999999999, $20.00+$0.80 USD Hold'em No Limit - Level IV (50/100) - 2010/06/05 18:36:30 WET [2010/06/05 13:36:30 ET]
Table '999999993 1' 10-max Seat #3 is the button
Seat 1: Player7 (1375 in chips) 
Seat 2: Player1 (1353 in chips) 
Seat 3: Player3 (3575 in chips) 
Seat 4: Player4 (1425 in chips) 
Seat 5: Player5 (1510 in chips) 
Seat 6: Player2 (1140 in chips) 
Seat 7: Player6 (1450 in chips) 
Seat 8: Hero (1692 in chips) 
Seat 10: Player8 (1480 in chips) 
Player7: posts the ante 10
Player1: posts the ante 10
Player3: posts the ante 10
Player4: posts the ante 10
Player5: posts the ante 10
Player2: posts the ante 10
Player6: posts the ante 10
Hero: posts the ante 10
Player8: posts the ante 10
Player4: posts small blind 50
Player5: posts big blind 100
*** HOLE CARDS ***
Dealt to Hero [Ts As]
Player2: folds 
Player6: folds 
Hero: raises 200 to 300
Player8: folds 
Player7: folds 
Player1: folds 
Player3: folds 
Player4: folds 
Player5: folds 
Uncalled bet (200) returned to Hero
Hero collected 340 from pot
Hero: doesn't show hand 
*** SUMMARY ***
Total pot 340 | Rake 0 
Seat 1: Player7 folded before Flop (didn't bet)
Seat 2: Player1 folded before Flop (didn't bet)
Seat 3: Player3 (button) folded before Flop (didn't bet)
Seat 4: Player4 (small blind) folded before Flop
Seat 5: Player5 (big blind) folded before Flop
Seat 6: Player2 folded before Flop (didn't bet)
Seat 7: Player6 folded before Flop (didn't bet)
Seat 8: Hero collected (340)
Seat 10: Player8 folded before Flop (didn't bet)



PokerStars Game #48301138530: Tournament #999999999, $20.00+$0.80 USD Hold'em No Limit - Level IV (50/100) - 2010/06/05 18:37:10 WET [2010/06/05 13:37:10 ET]
Table '999999993 1' 10-max Seat #4 is the button
Seat 1: Player7 (1365 in chips) 
Seat 2: Player1 (1343 in chips) 
Seat 3: Player3 (3565 in chips) 
Seat 4: Player4 (1365 in chips) 
Seat 5: Player5 (1400 in chips) 
Seat 6: Player2 (1130 in chips) 
Seat 7: Player6 (1440 in chips) 
Seat 8: Hero (1922 in chips) 
Seat 10: Player8 (1470 in chips) 
Player7: posts the ante 10
Player1: posts the ante 10
Player3: posts the ante 10
Player4: posts the ante 10
Player5: posts the ante 10
Player2: posts the ante 10
Player6: posts the ante 10
Hero: posts the ante 10
Player8: posts the ante 10
Player5: posts small blind 50
Player2: posts big blind 100
*** HOLE CARDS ***
Dealt to Hero [Th 7d]
Player6: folds 
Hero: folds 
Player8: folds 
Player7: folds 
Player1: folds 
Player3: raises 100 to 200
Player4: folds 
Player5: folds 
Player2: calls 100
*** FLOP *** [Ts 6c 5s]
Player2: checks 
Player3: bets 200
Player2: calls 200
*** TURN *** [Ts 6c 5s] [7s]
Player2: bets 300
Player3: folds 
Uncalled bet (300) returned to Player2
Player2 collected 940 from pot
Player2: doesn't show hand 
*** SUMMARY ***
Total pot 940 | Rake 0 
Board [Ts 6c 5s 7s]
Seat 1: Player7 folded before Flop (didn't bet)
Seat 2: Player1 folded before Flop (didn't bet)
Seat 3: Player3 folded on the Turn
Seat 4: Player4 (button) folded before Flop (didn't bet)
Seat 5: Player5 (small blind) folded before Flop
Seat 6: Player2 (big blind) collected (940)
Seat 7: Player6 folded before Flop (didn't bet)
Seat 8: Hero folded before Flop (didn't bet)
Seat 10: Player8 folded before Flop (didn't bet)



PokerStars Game #24109969712: Tournament #999999999, $20.00+$0.80 USD Hold'em No Limit - Level IV (50/100) - 2010/06/05 18:38:32 WET [2010/06/05 13:38:32 ET]
Table '999999993 1' 10-max Seat #5 is the button
Seat 1: Player7 (1355 in chips) 
Seat 2: Player1 (1333 in chips) 
Seat 3: Player3 (3155 in chips) 
Seat 4: Player4 (1355 in chips) 
Seat 5: Player5 (1340 in chips) 
Seat 6: Player2 (1660 in chips) 
Seat 7: Player6 (1430 in chips) 
Seat 8: Hero (1912 in chips) 
Seat 10: Player8 (1460 in chips) 
Player7: posts the ante 10
Player1: posts the ante 10
Player3: posts the ante 10
Player4: posts the ante 10
Player5: posts the ante 10
Player2: posts the ante 10
Player6: posts the ante 10
Hero: posts the ante 10
Player8: posts the ante 10
Player2: posts small blind 50
Player6: posts big blind 100
*** HOLE CARDS ***
Dealt to Hero [Tc 4c]
Hero: folds 
Player8: folds 
Player7: folds 
Player1: raises 1223 to 1323 and is all-in
Player3: folds 
Player4: folds 
Player5: folds 
Player2: folds 
Player6: folds 
Uncalled bet (1223) returned to Player1
Player1 collected 340 from pot
*** SUMMARY ***
Total pot 340 | Rake 0 
Seat 1: Player7 folded before Flop (didn't bet)
Seat 2: Player1 collected (340)
Seat 3: Player3 folded before Flop (didn't bet)
Seat 4: Player4 folded before Flop (didn't bet)
Seat 5: Player5 (button) folded before Flop (didn't bet)
Seat 6: Player2 (small blind) folded before Flop
Seat 7: Player6 (big blind) folded before Flop
Seat 8: Hero folded before Flop (didn't bet)
Seat 10: Player8 folded before Flop (didn't bet)



PokerStars Game #30792250485: Tournament #999999999, $20.00+$0.80 USD Hold'em No Limit - Level IV (50/100) - 2010/06/05 18:39:08 WET [2010/06/05 13:39:08 ET]
Table '999999993 1' 10-max Seat #6 is the button
Seat 1: Player7 (1345 in chips) 
Seat 2: Player1 (1563 in chips) 
Seat 3: Player3 (3145 in chips) 
Seat 4: Player4 (1345 in chips) 
Seat 5: Player5 (1330 in chips) 
Seat 6: Player2 (1600 in chips) 
Seat 7: Player6 (1320 in chips) 
Seat 8: Hero (1902 in chips) 
Seat 10: Player8 (1450 in chips) 
Player7: posts the ante 10
Player1: posts the ante 10
Player3: posts the ante 10
Player4: posts the ante 10
Player5: posts the ante 10
Player2: posts the ante 10
Player6: posts the ante 10
Hero: posts the ante 10
Player8: posts the ante 10
Player6: posts small blind 50
Hero: posts big blind 100
*** HOLE CARDS ***
Dealt to Hero [7s 2h]
Player8: folds 
Player7: folds 
Player1: folds 
Player3: folds 
Player4: folds 
Player5: folds 
Player2: folds 
Player6: folds 
Uncalled bet (50) returned to Hero
Hero collected 190 from pot
Hero: doesn't show hand 
*** SUMMARY ***
Total pot 190 | Rake 0 
Seat 1: Player7 folded before Flop (didn't bet)
Seat 2: Player1 folded before Flop (didn't bet)
Seat 3: Player3 folded before Flop (didn't bet)
Seat 4: Player4 folded before Flop (didn't bet)
Seat 5: Player5 folded before Flop (didn't bet)
Seat 6: Player2 (button) folded before Flop (didn't bet)
Seat 7: Player6 (small blind) folded before Flop
Seat 8: Hero (big blind) collected (190)
Seat 10: Player8 folded before Flop (didn't bet)



PokerStars Game #13065275367: Tournament #999999999, $20.00+$0.80 USD Hold'em No Limit - Level IV (50/100) - 2010/06/05 18:39:39 WET [2010/06/05 13:39:39 ET]
Table '999999993 1' 10-max Seat #7 is the button
Seat 1: Player7 (1335 in chips) 
Seat 2: Player1 (1553 in chips) 
Seat 3: Player3 (3135 in chips) 
Seat 4: Player4 (1335 in chips) 
Seat 5: Player5 (1320 in chips) 
Seat 6: Player2 (1590 in chips) 
Seat 7: Player6 (1260 in chips) 
Seat 8: Hero (2032 in chips) 
Seat 10: Player8 (1440 in chips) 
Player7: posts the ante 10
Player1: posts the ante 10
Player3: posts the ante 10
Player4: posts the ante 10
Player5: posts the ante 10
Player2: posts the ante 10
Player6: posts the ante 10
Hero: posts the ante 10
Player8: posts the ante 10
Hero: posts small blind 50
Player8: posts big blind 100
*** HOLE CARDS ***
Dealt to Hero [Jc 6h]
Player7: folds 
Player1: folds 
Player3: folds 
Player4: raises 100 to 200
Player5: folds 
Player2: raises 300 to 500
Player6: raises 750 to 1250 and is all-in
Hero: folds 
Player8: folds 
Player4: folds 
Player2: calls 750
*** FLOP *** [5s 9s 2c]
*** TURN *** [5s 9s 2c] [6d]
*** RIVER *** [5s 9s 2c 6d] [Qd]
*** SHOW DOWN ***
Player2: shows [Js Jd] (a pair of Jacks)
Player6: shows [Kc Ad] (high card Ace)
Player2 collected 2940 from pot
Player6 finished the tournament in 9th place
*** SUMMARY ***
Total pot 2940 | Rake 0 
Board [5s 9s 2c 6d Qd]
Seat 1: Player7 folded before Flop (didn't bet)
Seat 2: Player1 folded before Flop (didn't bet)
Seat 3: Player3 folded before Flop (didn't bet)
Seat 4: Player4 folded before Flop
Seat 5: Player5 folded before Flop (didn't bet)
Seat 6: Player2 showed [Js Jd] and won (2940) with a pair of Jacks
Seat 7: Player6 (button) showed [Kc Ad] and lost with high card Ace
Seat 8: Hero (small blind) folded before Flop
Seat 10: Player8 (big blind) folded before Flop



PokerStars Game #21787227501: Tournament #999999999, $20.00+$0.80 USD Hold'em No Limit - Level IV (50/100) - 2010/06/05 18:40:26 WET [2010/06/05 13:40:26 ET]
Table '999999993 1' 10-max Seat #8 is the button
Seat 1: Player7 (1325 in chips) 
Seat 2: Player1 (1543 in chips) 
Seat 3: Player3 (3125 in chips) 
Seat 4: Player4 (1125 in chips) 
Seat 5: Player5 (1310 in chips) 
Seat 6: Player2 (3270 in chips) 
Seat 8: Hero (1972 in chips) 
Seat 10: Player8 (1330 in chips) 
Player7: posts the ante 10
Player1: posts the ante 10
Player3: posts the ante 10
Player4: posts the ante 10
Player5: posts the ante 10
Player2: posts the ante 10
Hero: posts the ante 10
Player8: posts the ante 10
Player8: posts small blind 50
Player7: posts big blind 100
*** HOLE CARDS ***
Dealt to Hero [Tc Kd]
Player4 said, "Hey Newfyboy,, you were ragging everyone about fishing at our last table,,,,what about you shoving all in to me with Q 10  in the small blind position and me busting you with KK"
Player1: raises 1433 to 1533 and is all-in
Player3: folds 
Player4: folds 
Player5: folds 
Player2: folds 
Hero: folds 
Player8: folds 
Player7: folds 
Uncalled bet (1433) returned to Player1
Player1 collected 330 from pot
*** SUMMARY ***
Total pot 330 | Rake 0 
Seat 1: Player7 (big blind) folded before Flop
Seat 2: Player1 collected (330)
Seat 3: Player3 folded before Flop (didn't bet)
Seat 4: Player4 folded before Flop (didn't bet)
Seat 5: Player5 folded before Flop (didn't bet)
Seat 6: Player2 folded before Flop (didn't bet)
Seat 8: Hero (button) folded before Flop (didn't bet)
Seat 10: Player8 (small blind) folded before Flop



PokerStars Game #97333030912: Tournament #999999999, $20.00+$0.80 USD Hold'em No Limit - Level IV (50/100) - 2010/06/05 18:40:57 WET [2010/06/05 13:40:57 ET]
Table '999999993 1' 10-max Seat #10 is the button
Seat 1: Player7 (1215 in chips) 
Seat 2: Player1 (1763 in chips) 
Seat 3: Player3 (3115 in chips) 
Seat 4: Player4 (1115 in chips) 
Seat 5: Player5 (1300 in chips) 
Seat 6: Player2 (3260 in chips) 
Seat 8: Hero (1962 in chips) 
Seat 10: Player8 (1270 in chips) 
Player7: posts the ante 10
Player1: posts the ante 10
Player3: posts the ante 10
Player4: posts the ante 10
Player5: posts the ante 10
Player2: posts the ante 10
Hero: posts the ante 10
Player8: posts the ante 10
Player7: posts small blind 50
Player1: posts big blind 100
*** HOLE CARDS ***
Dealt to Hero [2s Js]
Player3: folds 
Player4: raises 200 to 300
Hero is connected 
Player5 said, "i wasnt ragging everyone..just the guy that donked me in a couple trnys"
Player5: folds 
Player2: folds 
Player4 said, "oh,,,"
Hero: folds 
Hero is sitting out
Player8: folds 
Player7: folds 
Hero has returned
Player1: folds 
Uncalled bet (200) returned to Player4
Player4 collected 330 from pot
Player4: shows [Ah Ac] (a pair of Aces)
*** SUMMARY ***
Total pot 330 | Rake 0 
Seat 1: Player7 (small blind) folded before Flop
Seat 2: Player1 (big blind) folded before Flop
Seat 3: Player3 folded before Flop (didn't bet)
Seat 4: Player4 collected (330)
Seat 5: Player5 folded before Flop (didn't bet)
Seat 6: Player2 folded before Flop (didn't bet)
Seat 8: Hero folded before Flop (didn't bet)
Seat 10: Player8 (button) folded before Flop (didn't bet)



PokerStars Game #15498191522: Tournament #999999999, $20.00+$0.80 USD Hold'em No Limit - Level V (75/150) - 2010/06/05 18:41:53 WET [2010/06/05 13:41:53 ET]
Table '999999993 1' 10-max Seat #1 is the button
Seat 1: Player7 (1155 in chips) 
Seat 2: Player1 (1653 in chips) 
Seat 3: Player3 (3105 in chips) 
Seat 4: Player4 (1335 in chips) 
Seat 5: Player5 (1290 in chips) 
Seat 6: Player2 (3250 in chips) 
Seat 8: Hero (1952 in chips) 
Seat 10: Player8 (1260 in chips) 
Player7: posts the ante 15
Player1: posts the ante 15
Player3: posts the ante 15
Player4: posts the ante 15
Player5: posts the ante 15
Player2: posts the ante 15
Hero: posts the ante 15
Player8: posts the ante 15
Player1: posts small blind 75
Player3: posts big blind 150
*** HOLE CARDS ***
Dealt to Hero [9d Tc]
Player4: folds 
Player5: folds 
Player2: folds 
Hero: folds 
Player8: folds 
Player7: raises 990 to 1140 and is all-in
Player1: folds 
Player3: folds 
Uncalled bet (990) returned to Player7
Player7 collected 495 from pot
Player7: doesn't show hand 
*** SUMMARY ***
Total pot 495 | Rake 0 
Seat 1: Player7 (button) collected (495)
Seat 2: Player1 (small blind) folded before Flop
Seat 3: Player3 (big blind) folded before Flop
Seat 4: Player4 folded before Flop (didn't bet)
Seat 5: Player5 folded before Flop (didn't bet)
Seat 6: Player2 folded before Flop (didn't bet)
Seat 8: Hero folded before Flop (didn't bet)
Seat 10: Player8 folded before Flop (didn't bet)



PokerStars Game #14585315141: Tournament #999999999, $20.00+$0.80 USD Hold'em No Limit - Level V (75/150) - 2010/06/05 18:42:25 WET [2010/06/05 13:42:25 ET]
Table '999999993 1' 10-max Seat #2 is the button
Seat 1: Player7 (1485 in chips) 
Seat 2: Player1 (1563 in chips) 
Seat 3: Player3 (2940 in chips) 
Seat 4: Player4 (1320 in chips) 
Seat 5: Player5 (1275 in chips) 
Seat 6: Player2 (3235 in chips) 
Seat 8: Hero (1937 in chips) 
Seat 10: Player8 (1245 in chips) 
Player7: posts the ante 15
Player1: posts the ante 15
Player3: posts the ante 15
Player4: posts the ante 15
Player5: posts the ante 15
Player2: posts the ante 15
Hero: posts the ante 15
Player8: posts the ante 15
Player3: posts small blind 75
Player4: posts big blind 150
*** HOLE CARDS ***
Dealt to Hero [Jh 7d]
Player4 said, "just unlucky timing is all"
Player5: folds 
Player2: folds 
Hero: folds 
Player8: folds 
Player7: raises 1320 to 1470 and is all-in
Player1: folds 
Player3: folds 
Player4: folds 
Uncalled bet (1320) returned to Player7
Player7 collected 495 from pot
*** SUMMARY ***
Total pot 495 | Rake 0 
Seat 1: Player7 collected (495)
Seat 2: Player1 (button) folded before Flop (didn't bet)
Seat 3: Player3 (small blind) folded before Flop
Seat 4: Player4 (big blind) folded before Flop
Seat 5: Player5 folded before Flop (didn't bet)
Seat 6: Player2 folded before Flop (didn't bet)
Seat 8: Hero folded before Flop (didn't bet)
Seat 10: Player8 folded before Flop (didn't bet)



PokerStars Game #11948180943: Tournament #999999999, $20.00+$0.80 USD Hold'em No Limit - Level V (75/150) - 2010/06/05 18:42:54 WET [2010/06/05 13:42:54 ET]
Table '999999993 1' 10-max Seat #3 is the button
Seat 1: Player7 (1815 in chips) 
Seat 2: Player1 (1548 in chips) 
Seat 3: Player3 (2850 in chips) 
Seat 4: Player4 (1155 in chips) 
Seat 5: Player5 (1260 in chips) 
Seat 6: Player2 (3220 in chips) 
Seat 8: Hero (1922 in chips) 
Seat 10: Player8 (1230 in chips) 
Player7: posts the ante 15
Player1: posts the ante 15
Player3: posts the ante 15
Player4: posts the ante 15
Player5: posts the ante 15
Player2: posts the ante 15
Hero: posts the ante 15
Player8: posts the ante 15
Player4: posts small blind 75
Player5: posts big blind 150
*** HOLE CARDS ***
Dealt to Hero [Td 6d]
Player2: folds 
Hero: folds 
Player8: folds 
Player7: folds 
Player1: folds 
Player3: folds 
Player4: calls 75
Player5: checks 
*** FLOP *** [9h 3s 7d]
Player4: bets 450
Player5: folds 
Uncalled bet (450) returned to Player4
Player4 collected 420 from pot
Player4: shows [Kc 9c] (a pair of Nines)
*** SUMMARY ***
Total pot 420 | Rake 0 
Board [9h 3s 7d]
Seat 1: Player7 folded before Flop (didn't bet)
Seat 2: Player1 folded before Flop (didn't bet)
Seat 3: Player3 (button) folded before Flop (didn't bet)
Seat 4: Player4 (small blind) collected (420)
Seat 5: Player5 (big blind) folded on the Flop
Seat 6: Player2 folded before Flop (didn't bet)
Seat 8: Hero folded before Flop (didn't bet)
Seat 10: Player8 folded before Flop (didn't bet)



PokerStars Game #17624911842: Tournament #999999999, $20.00+$0.80 USD Hold'em No Limit - Level V (75/150) - 2010/06/05 18:43:33 WET [2010/06/05 13:43:33 ET]
Table '999999993 1' 10-max Seat #4 is the button
Seat 1: Player7 (1800 in chips) 
Seat 2: Player1 (1533 in chips) 
Seat 3: Player3 (2835 in chips) 
Seat 4: Player4 (1410 in chips) 
Seat 5: Player5 (1095 in chips) 
Seat 6: Player2 (3205 in chips) 
Seat 8: Hero (1907 in chips) 
Seat 10: Player8 (1215 in chips) 
Player7: posts the ante 15
Player1: posts the ante 15
Player3: posts the ante 15
Player4: posts the ante 15
Player5: posts the ante 15
Player2: posts the ante 15
Hero: posts the ante 15
Player8: posts the ante 15
Player5: posts small blind 75
Player2: posts big blind 150
*** HOLE CARDS ***
Dealt to Hero [3c 5h]
Hero: folds 
Player8: folds 
Player7: folds 
Player1: folds 
Player3: folds 
Player4: folds 
Player5: raises 930 to 1080 and is all-in
Player2: folds 
Uncalled bet (930) returned to Player5
Player5 collected 420 from pot
Player5: doesn't show hand 
*** SUMMARY ***
Total pot 420 | Rake 0 
Seat 1: Player7 folded before Flop (didn't bet)
Seat 2: Player1 folded before Flop (didn't bet)
Seat 3: Player3 folded before Flop (didn't bet)
Seat 4: Player4 (button) folded before Flop (didn't bet)
Seat 5: Player5 (small blind) collected (420)
Seat 6: Player2 (big blind) folded before Flop
Seat 8: Hero folded before Flop (didn't bet)
Seat 10: Player8 folded before Flop (didn't bet)



PokerStars Game #23032927970: Tournament #999999999, $20.00+$0.80 USD Hold'em No Limit - Level V (75/150) - 2010/06/05 18:43:56 WET [2010/06/05 13:43:56 ET]
Table '999999993 1' 10-max Seat #5 is the button
Seat 1: Player7 (1785 in chips) 
Seat 2: Player1 (1518 in chips) 
Seat 3: Player3 (2820 in chips) 
Seat 4: Player4 (1395 in chips) 
Seat 5: Player5 (1350 in chips) 
Seat 6: Player2 (3040 in chips) 
Seat 8: Hero (1892 in chips) 
Seat 10: Player8 (1200 in chips) 
Player7: posts the ante 15
Player1: posts the ante 15
Player3: posts the ante 15
Player4: posts the ante 15
Player5: posts the ante 15
Player2: posts the ante 15
Hero: posts the ante 15
Player8: posts the ante 15
Player2: posts small blind 75
Hero: posts big blind 150
*** HOLE CARDS ***
Dealt to Hero [Tc 8s]
Player8: folds 
Player7: folds 
Player1: folds 
Player3: folds 
Player5 said, "3 outered once again..had k 10"
Player4: folds 
Player5: folds 
Player2: folds 
Uncalled bet (75) returned to Hero
Hero collected 270 from pot
Hero: doesn't show hand 
*** SUMMARY ***
Total pot 270 | Rake 0 
Seat 1: Player7 folded before Flop (didn't bet)
Seat 2: Player1 folded before Flop (didn't bet)
Seat 3: Player3 folded before Flop (didn't bet)
Seat 4: Player4 folded before Flop (didn't bet)
Seat 5: Player5 (button) folded before Flop (didn't bet)
Seat 6: Player2 (small blind) folded before Flop
Seat 8: Hero (big blind) collected (270)
Seat 10: Player8 folded before Flop (didn't bet)



PokerStars Game #23986188992: Tournament #999999999, $20.00+$0.80 USD Hold'em No Limit - Level V (75/150) - 2010/06/05 18:44:24 WET [2010/06/05 13:44:24 ET]
Table '999999993 1' 10-max Seat #6 is the button
Seat 1: Player7 (1770 in chips) 
Seat 2: Player1 (1503 in chips) 
Seat 3: Player3 (2805 in chips) 
Seat 4: Player4 (1380 in chips) 
Seat 5: Player5 (1335 in chips) 
Seat 6: Player2 (2950 in chips) 
Seat 8: Hero (2072 in chips) 
Seat 10: Player8 (1185 in chips) 
Player7: posts the ante 15
Player1: posts the ante 15
Player3: posts the ante 15
Player4: posts the ante 15
Player5: posts the ante 15
Player2: posts the ante 15
Hero: posts the ante 15
Player8: posts the ante 15
Hero: posts small blind 75
Player8: posts big blind 150
*** HOLE CARDS ***
Dealt to Hero [2c 6h]
Player7: folds 
Player4 said, "i showed,,,,you see K 9"
Player1: folds 
Player3: folds 
Player4: folds 
Player5: folds 
Player2: folds 
Hero: folds 
Uncalled bet (75) returned to Player8
Player8 collected 270 from pot
Player8: doesn't show hand 
*** SUMMARY ***
Total pot 270 | Rake 0 
Seat 1: Player7 folded before Flop (didn't bet)
Seat 2: Player1 folded before Flop (didn't bet)
Seat 3: Player3 folded before Flop (didn't bet)
Seat 4: Player4 folded before Flop (didn't bet)
Seat 5: Player5 folded before Flop (didn't bet)
Seat 6: Player2 (button) folded before Flop (didn't bet)
Seat 8: Hero (small blind) folded before Flop
Seat 10: Player8 (big blind) collected (270)



PokerStars Game #56828726239: Tournament #999999999, $20.00+$0.80 USD Hold'em No Limit - Level V (75/150) - 2010/06/05 18:45:08 WET [2010/06/05 13:45:08 ET]
Table '999999993 1' 10-max Seat #8 is the button
Seat 1: Player7 (1755 in chips) 
Seat 2: Player1 (1488 in chips) 
Seat 3: Player3 (2790 in chips) 
Seat 4: Player4 (1365 in chips) 
Seat 5: Player5 (1320 in chips) 
Seat 6: Player2 (2935 in chips) 
Seat 8: Hero (1982 in chips) 
Seat 10: Player8 (1365 in chips) 
Player7: posts the ante 15
Player1: posts the ante 15
Player3: posts the ante 15
Player4: posts the ante 15
Player5: posts the ante 15
Player2: posts the ante 15
Hero: posts the ante 15
Player8: posts the ante 15
Player8: posts small blind 75
Player7: posts big blind 150
*** HOLE CARDS ***
Dealt to Hero [Js 6d]
Player1: folds 
Player3: folds 
Player4: folds 
Player5: folds 
Player2: folds 
Hero: raises 1817 to 1967 and is all-in
Player8: folds 
Player7: folds 
Uncalled bet (1817) returned to Hero
Hero collected 495 from pot
*** SUMMARY ***
Total pot 495 | Rake 0 
Seat 1: Player7 (big blind) folded before Flop
Seat 2: Player1 folded before Flop (didn't bet)
Seat 3: Player3 folded before Flop (didn't bet)
Seat 4: Player4 folded before Flop (didn't bet)
Seat 5: Player5 folded before Flop (didn't bet)
Seat 6: Player2 folded before Flop (didn't bet)
Seat 8: Hero (button) collected (495)
Seat 10: Player8 (small blind) folded before Flop



PokerStars Game #38112793216: Tournament #999999999, $20.00+$0.80 USD Hold'em No Limit - Level V (75/150) - 2010/06/05 18:45:39 WET [2010/06/05 13:45:39 ET]
Table '999999993 1' 10-max Seat #10 is the button
Seat 1: Player7 (1590 in chips) 
Seat 2: Player1 (1473 in chips) 
Seat 3: Player3 (2775 in chips) 
Seat 4: Player4 (1350 in chips) 
Seat 5: Player5 (1305 in chips) 
Seat 6: Player2 (2920 in chips) 
Seat 8: Hero (2312 in chips) 
Seat 10: Player8 (1275 in chips) 
Player7: posts the ante 15
Player1: posts the ante 15
Player3: posts the ante 15
Player4: posts the ante 15
Player5: posts the ante 15
Player2: posts the ante 15
Hero: posts the ante 15
Player8: posts the ante 15
Player7: posts small blind 75
Player1: posts big blind 150
*** HOLE CARDS ***
Dealt to Hero [4s Ks]
Player3: folds 
Player4: folds 
Player5: folds 
Player2: folds 
Hero: folds 
Player8: raises 1110 to 1260 and is all-in
Player7: folds 
Player1: folds 
Uncalled bet (1110) returned to Player8
Player8 collected 495 from pot
Player8: doesn't show hand 
*** SUMMARY ***
Total pot 495 | Rake 0 
Seat 1: Player7 (small blind) folded before Flop
Seat 2: Player1 (big blind) folded before Flop
Seat 3: Player3 folded before Flop (didn't bet)
Seat 4: Player4 folded before Flop (didn't bet)
Seat 5: Player5 folded before Flop (didn't bet)
Seat 6: Player2 folded before Flop (didn't bet)
Seat 8: Hero folded before Flop (didn't bet)
Seat 10: Player8 (button) collected (495)



PokerStars Game #31069130752: Tournament #999999999, $20.00+$0.80 USD Hold'em No Limit - Level VI (100/200) - 2010/06/05 18:46:08 WET [2010/06/05 13:46:08 ET]
Table '999999993 1' 10-max Seat #1 is the button
Seat 1: Player7 (1500 in chips) 
Seat 2: Player1 (1308 in chips) 
Seat 3: Player3 (2760 in chips) 
Seat 4: Player4 (1335 in chips) 
Seat 5: Player5 (1290 in chips) 
Seat 6: Player2 (2905 in chips) 
Seat 8: Hero (2297 in chips) 
Seat 10: Player8 (1605 in chips) 
Player7: posts the ante 20
Player1: posts the ante 20
Player3: posts the ante 20
Player4: posts the ante 20
Player5: posts the ante 20
Player2: posts the ante 20
Hero: posts the ante 20
Player8: posts the ante 20
Player1: posts small blind 100
Player3: posts big blind 200
*** HOLE CARDS ***
Dealt to Hero [5d Ac]
Player4: raises 600 to 800
Player5: folds 
Player2: folds 
Hero: folds 
Player8: folds 
Player7: folds 
Player1: folds 
Player3: folds 
Uncalled bet (600) returned to Player4
Player4 collected 660 from pot
*** SUMMARY ***
Total pot 660 | Rake 0 
Seat 1: Player7 (button) folded before Flop (didn't bet)
Seat 2: Player1 (small blind) folded before Flop
Seat 3: Player3 (big blind) folded before Flop
Seat 4: Player4 collected (660)
Seat 5: Player5 folded before Flop (didn't bet)
Seat 6: Player2 folded before Flop (didn't bet)
Seat 8: Hero folded before Flop (didn't bet)
Seat 10: Player8 folded before Flop (didn't bet)



PokerStars Game #32482731311: Tournament #999999999, $20.00+$0.80 USD Hold'em No Limit - Level VI (100/200) - 2010/06/05 18:46:45 WET [2010/06/05 13:46:45 ET]
Table '999999993 1' 10-max Seat #2 is the button
Seat 1: Player7 (1480 in chips) 
Seat 2: Player1 (1188 in chips) 
Seat 3: Player3 (2540 in chips) 
Seat 4: Player4 (1775 in chips) 
Seat 5: Player5 (1270 in chips) 
Seat 6: Player2 (2885 in chips) 
Seat 8: Hero (2277 in chips) 
Seat 10: Player8 (1585 in chips) 
Player7: posts the ante 20
Player1: posts the ante 20
Player3: posts the ante 20
Player4: posts the ante 20
Player5: posts the ante 20
Player2: posts the ante 20
Hero: posts the ante 20
Player8: posts the ante 20
Player3: posts small blind 100
Player4: posts big blind 200
*** HOLE CARDS ***
Dealt to Hero [Qc Ac]
Player5: folds 
Player2: folds 
Hero: raises 2057 to 2257 and is all-in
Player8: folds 
Player7: folds 
Player1: folds 
Player3: folds 
Player4: folds 
Uncalled bet (2057) returned to Hero
Hero collected 660 from pot
Hero: doesn't show hand 
*** SUMMARY ***
Total pot 660 | Rake 0 
Seat 1: Player7 folded before Flop (didn't bet)
Seat 2: Player1 (button) folded before Flop (didn't bet)
Seat 3: Player3 (small blind) folded before Flop
Seat 4: Player4 (big blind) folded before Flop
Seat 5: Player5 folded before Flop (didn't bet)
Seat 6: Player2 folded before Flop (didn't bet)
Seat 8: Hero collected (660)
Seat 10: Player8 folded before Flop (didn't bet)



PokerStars Game #88351539130: Tournament #999999999, $20.00+$0.80 USD Hold'em No Limit - Level VI (100/200) - 2010/06/05 18:47:21 WET [2010/06/05 13:47:21 ET]
Table '999999993 1' 10-max Seat #3 is the button
Seat 1: Player7 (1460 in chips) 
Seat 2: Player1 (1168 in chips) 
Seat 3: Player3 (2420 in chips) 
Seat 4: Player4 (1555 in chips) 
Seat 5: Player5 (1250 in chips) 
Seat 6: Player2 (2865 in chips) 
Seat 8: Hero (2717 in chips) 
Seat 10: Player8 (1565 in chips) 
Player7: posts the ante 20
Player1: posts the ante 20
Player3: posts the ante 20
Player4: posts the ante 20
Player5: posts the ante 20
Player2: posts the ante 20
Hero: posts the ante 20
Player8: posts the ante 20
Player4: posts small blind 100
Player5: posts big blind 200
*** HOLE CARDS ***
Dealt to Hero [4d 8d]
Player2: folds 
Hero: folds 
Player8: raises 1345 to 1545 and is all-in
Player7: folds 
Player1: folds 
Player3: folds 
Player4: folds 
Player5: folds 
Uncalled bet (1345) returned to Player8
Player8 collected 660 from pot
Player8: doesn't show hand 
*** SUMMARY ***
Total pot 660 | Rake 0 
Seat 1: Player7 folded before Flop (didn't bet)
Seat 2: Player1 folded before Flop (didn't bet)
Seat 3: Player3 (button) folded before Flop (didn't bet)
Seat 4: Player4 (small blind) folded before Flop
Seat 5: Player5 (big blind) folded before Flop
Seat 6: Player2 folded before Flop (didn't bet)
Seat 8: Hero folded before Flop (didn't bet)
Seat 10: Player8 collected (660)



PokerStars Game #17361301211: Tournament #999999999, $20.00+$0.80 USD Hold'em No Limit - Level VI (100/200) - 2010/06/05 18:47:46 WET [2010/06/05 13:47:46 ET]
Table '999999993 1' 10-max Seat #4 is the button
Seat 1: Player7 (1440 in chips) 
Seat 2: Player1 (1148 in chips) 
Seat 3: Player3 (2400 in chips) 
Seat 4: Player4 (1435 in chips) 
Seat 5: Player5 (1030 in chips) 
Seat 6: Player2 (2845 in chips) 
Seat 8: Hero (2697 in chips) 
Seat 10: Player8 (2005 in chips) 
Player7: posts the ante 20
Player1: posts the ante 20
Player3: posts the ante 20
Player4: posts the ante 20
Player5: posts the ante 20
Player2: posts the ante 20
Hero: posts the ante 20
Player8: posts the ante 20
Player5: posts small blind 100
Player2: posts big blind 200
*** HOLE CARDS ***
Dealt to Hero [Tc 9d]
Hero: folds 
Player8: folds 
Player7: folds 
Player1: folds 
Player3: raises 2180 to 2380 and is all-in
Player4: folds 
Player5: folds 
Player2: folds 
Uncalled bet (2180) returned to Player3
Player3 collected 660 from pot
Player3: doesn't show hand 
*** SUMMARY ***
Total pot 660 | Rake 0 
Seat 1: Player7 folded before Flop (didn't bet)
Seat 2: Player1 folded before Flop (didn't bet)
Seat 3: Player3 collected (660)
Seat 4: Player4 (button) folded before Flop (didn't bet)
Seat 5: Player5 (small blind) folded before Flop
Seat 6: Player2 (big blind) folded before Flop
Seat 8: Hero folded before Flop (didn't bet)
Seat 10: Player8 folded before Flop (didn't bet)



PokerStars Game #97221803271: Tournament #999999999, $20.00+$0.80 USD Hold'em No Limit - Level VI (100/200) - 2010/06/05 18:48:23 WET [2010/06/05 13:48:23 ET]
Table '999999993 1' 10-max Seat #5 is the button
Seat 1: Player7 (1420 in chips) 
Seat 2: Player1 (1128 in chips) 
Seat 3: Player3 (2840 in chips) 
Seat 4: Player4 (1415 in chips) 
Seat 5: Player5 (910 in chips) 
Seat 6: Player2 (2625 in chips) 
Seat 8: Hero (2677 in chips) 
Seat 10: Player8 (1985 in chips) 
Player7: posts the ante 20
Player1: posts the ante 20
Player3: posts the ante 20
Player4: posts the ante 20
Player5: posts the ante 20
Player2: posts the ante 20
Hero: posts the ante 20
Player8: posts the ante 20
Player2: posts small blind 100
Hero: posts big blind 200
*** HOLE CARDS ***
Dealt to Hero [Th Jd]
Player8: folds 
Player7: raises 1200 to 1400 and is all-in
Player1: folds 
Player3: folds 
Player4: folds 
Player5: folds 
Player2: folds 
Hero: folds 
Uncalled bet (1200) returned to Player7
Player7 collected 660 from pot
*** SUMMARY ***
Total pot 660 | Rake 0 
Seat 1: Player7 collected (660)
Seat 2: Player1 folded before Flop (didn't bet)
Seat 3: Player3 folded before Flop (didn't bet)
Seat 4: Player4 folded before Flop (didn't bet)
Seat 5: Player5 (button) folded before Flop (didn't bet)
Seat 6: Player2 (small blind) folded before Flop
Seat 8: Hero (big blind) folded before Flop
Seat 10: Player8 folded before Flop (didn't bet)



PokerStars Game #15548756265: Tournament #999999999, $20.00+$0.80 USD Hold'em No Limit - Level VI (100/200) - 2010/06/05 18:49:16 WET [2010/06/05 13:49:16 ET]
Table '999999993 1' 10-max Seat #6 is the button
Seat 1: Player7 (1860 in chips) 
Seat 2: Player1 (1108 in chips) 
Seat 3: Player3 (2820 in chips) 
Seat 4: Player4 (1395 in chips) 
Seat 5: Player5 (890 in chips) 
Seat 6: Player2 (2505 in chips) 
Seat 8: Hero (2457 in chips) 
Seat 10: Player8 (1965 in chips) 
Player7: posts the ante 20
Player1: posts the ante 20
Player3: posts the ante 20
Player4: posts the ante 20
Player5: posts the ante 20
Player2: posts the ante 20
Hero: posts the ante 20
Player8: posts the ante 20
Hero: posts small blind 100
Player8: posts big blind 200
*** HOLE CARDS ***
Dealt to Hero [Kc 8s]
Player7: folds 
Player1: folds 
Player3: folds 
Player4: folds 
Player5: folds 
Player2: folds 
Hero: raises 1200 to 1400
Player8: folds 
Uncalled bet (1200) returned to Hero
Hero collected 560 from pot
Hero: doesn't show hand 
*** SUMMARY ***
Total pot 560 | Rake 0 
Seat 1: Player7 folded before Flop (didn't bet)
Seat 2: Player1 folded before Flop (didn't bet)
Seat 3: Player3 folded before Flop (didn't bet)
Seat 4: Player4 folded before Flop (didn't bet)
Seat 5: Player5 folded before Flop (didn't bet)
Seat 6: Player2 (button) folded before Flop (didn't bet)
Seat 8: Hero (small blind) collected (560)
Seat 10: Player8 (big blind) folded before Flop



PokerStars Game #12086528146: Tournament #999999999, $20.00+$0.80 USD Hold'em No Limit - Level VI (100/200) - 2010/06/05 18:49:41 WET [2010/06/05 13:49:41 ET]
Table '999999993 1' 10-max Seat #8 is the button
Seat 1: Player7 (1840 in chips) 
Seat 2: Player1 (1088 in chips) 
Seat 3: Player3 (2800 in chips) 
Seat 4: Player4 (1375 in chips) 
Seat 5: Player5 (870 in chips) 
Seat 6: Player2 (2485 in chips) 
Seat 8: Hero (2797 in chips) 
Seat 10: Player8 (1745 in chips) 
Player7: posts the ante 20
Player1: posts the ante 20
Player3: posts the ante 20
Player4: posts the ante 20
Player5: posts the ante 20
Player2: posts the ante 20
Hero: posts the ante 20
Player8: posts the ante 20
Player8: posts small blind 100
Player7: posts big blind 200
*** HOLE CARDS ***
Dealt to Hero [9h 4h]
Player1: raises 868 to 1068 and is all-in
Player3: raises 1712 to 2780 and is all-in
Player4: folds 
Player5: folds 
Player2: folds 
Hero: folds 
Player8: folds 
Player7: folds 
Uncalled bet (1712) returned to Player3
*** FLOP *** [4s 7h 7s]
*** TURN *** [4s 7h 7s] [4c]
*** RIVER *** [4s 7h 7s 4c] [9s]
*** SHOW DOWN ***
Player1: shows [Ts Ks] (a flush, King high)
Player3: shows [Qh Ad] (two pair, Sevens and Fours)
Player1 collected 2596 from pot
*** SUMMARY ***
Total pot 2596 | Rake 0 
Board [4s 7h 7s 4c 9s]
Seat 1: Player7 (big blind) folded before Flop
Seat 2: Player1 showed [Ts Ks] and won (2596) with a flush, King high
Seat 3: Player3 showed [Qh Ad] and lost with two pair, Sevens and Fours
Seat 4: Player4 folded before Flop (didn't bet)
Seat 5: Player5 folded before Flop (didn't bet)
Seat 6: Player2 folded before Flop (didn't bet)
Seat 8: Hero (button) folded before Flop (didn't bet)
Seat 10: Player8 (small blind) folded before Flop



PokerStars Game #13697312495: Tournament #999999999, $20.00+$0.80 USD Hold'em No Limit - Level VI (100/200) - 2010/06/05 18:50:27 WET [2010/06/05 13:50:27 ET]
Table '999999993 1' 10-max Seat #10 is the button
Seat 1: Player7 (1620 in chips) 
Seat 2: Player1 (2596 in chips) 
Seat 3: Player3 (1712 in chips) 
Seat 4: Player4 (1355 in chips) 
Seat 5: Player5 (850 in chips) 
Seat 6: Player2 (2465 in chips) 
Seat 8: Hero (2777 in chips) 
Seat 10: Player8 (1625 in chips) 
Player7: posts the ante 20
Player1: posts the ante 20
Player3: posts the ante 20
Player4: posts the ante 20
Player5: posts the ante 20
Player2: posts the ante 20
Hero: posts the ante 20
Player8: posts the ante 20
Player7: posts small blind 100
Player1: posts big blind 200
*** HOLE CARDS ***
Dealt to Hero [9c 6h]
Player3: folds 
Player4: folds 
Player5: folds 
Player2: folds 
Hero: folds 
Player8: raises 1405 to 1605 and is all-in
Player7: folds 
Player1: folds 
Uncalled bet (1405) returned to Player8
Player8 collected 660 from pot
Player8: doesn't show hand 
*** SUMMARY ***
Total pot 660 | Rake 0 
Seat 1: Player7 (small blind) folded before Flop
Seat 2: Player1 (big blind) folded before Flop
Seat 3: Player3 folded before Flop (didn't bet)
Seat 4: Player4 folded before Flop (didn't bet)
Seat 5: Player5 folded before Flop (didn't bet)
Seat 6: Player2 folded before Flop (didn't bet)
Seat 8: Hero folded before Flop (didn't bet)
Seat 10: Player8 (button) collected (660)



PokerStars Game #13761146921: Tournament #999999999, $20.00+$0.80 USD Hold'em No Limit - Level VI (100/200) - 2010/06/05 18:51:00 WET [2010/06/05 13:51:00 ET]
Table '999999993 1' 10-max Seat #1 is the button
Seat 1: Player7 (1500 in chips) 
Seat 2: Player1 (2376 in chips) 
Seat 3: Player3 (1692 in chips) 
Seat 4: Player4 (1335 in chips) 
Seat 5: Player5 (830 in chips) 
Seat 6: Player2 (2445 in chips) 
Seat 8: Hero (2757 in chips) 
Seat 10: Player8 (2065 in chips) 
Player7: posts the ante 20
Player1: posts the ante 20
Player3: posts the ante 20
Player4: posts the ante 20
Player5: posts the ante 20
Player2: posts the ante 20
Hero: posts the ante 20
Player8: posts the ante 20
Player1: posts small blind 100
Player3: posts big blind 200
*** HOLE CARDS ***
Dealt to Hero [Qh 3h]
Player4: folds 
Player5: raises 610 to 810 and is all-in
Player2: folds 
Hero: folds 
Player8: folds 
Player7: folds 
Player1: folds 
Player3: folds 
Uncalled bet (610) returned to Player5
Player5 collected 660 from pot
Player5: doesn't show hand 
*** SUMMARY ***
Total pot 660 | Rake 0 
Seat 1: Player7 (button) folded before Flop (didn't bet)
Seat 2: Player1 (small blind) folded before Flop
Seat 3: Player3 (big blind) folded before Flop
Seat 4: Player4 folded before Flop (didn't bet)
Seat 5: Player5 collected (660)
Seat 6: Player2 folded before Flop (didn't bet)
Seat 8: Hero folded before Flop (didn't bet)
Seat 10: Player8 folded before Flop (didn't bet)



PokerStars Game #30422752324: Tournament #999999999, $20.00+$0.80 USD Hold'em No Limit - Level VII (125/250) - 2010/06/05 18:51:36 WET [2010/06/05 13:51:36 ET]
Table '999999993 1' 10-max Seat #2 is the button
Seat 1: Player7 (1480 in chips) 
Seat 2: Player1 (2256 in chips) 
Seat 3: Player3 (1472 in chips) 
Seat 4: Player4 (1315 in chips) 
Seat 5: Player5 (1270 in chips) 
Seat 6: Player2 (2425 in chips) 
Seat 8: Hero (2737 in chips) 
Seat 10: Player8 (2045 in chips) 
Player7: posts the ante 25
Player1: posts the ante 25
Player3: posts the ante 25
Player4: posts the ante 25
Player5: posts the ante 25
Player2: posts the ante 25
Hero: posts the ante 25
Player8: posts the ante 25
Player3: posts small blind 125
Player4: posts big blind 250
*** HOLE CARDS ***
Dealt to Hero [7c 9c]
Player5: folds 
Player2: folds 
Hero: folds 
Player8: folds 
Player7: folds 
Player1: folds 
Player3: raises 250 to 500
Player4: raises 500 to 1000
Player3: folds 
Uncalled bet (500) returned to Player4
Player4 collected 1200 from pot
Player4: shows [Ad As] (a pair of Aces)
*** SUMMARY ***
Total pot 1200 | Rake 0 
Seat 1: Player7 folded before Flop (didn't bet)
Seat 2: Player1 (button) folded before Flop (didn't bet)
Seat 3: Player3 (small blind) folded before Flop
Seat 4: Player4 (big blind) collected (1200)
Seat 5: Player5 folded before Flop (didn't bet)
Seat 6: Player2 folded before Flop (didn't bet)
Seat 8: Hero folded before Flop (didn't bet)
Seat 10: Player8 folded before Flop (didn't bet)



PokerStars Game #24883115542: Tournament #999999999, $20.00+$0.80 USD Hold'em No Limit - Level VII (125/250) - 2010/06/05 18:52:18 WET [2010/06/05 13:52:18 ET]
Table '999999993 1' 10-max Seat #3 is the button
Seat 1: Player7 (1455 in chips) 
Seat 2: Player1 (2231 in chips) 
Seat 3: Player3 (947 in chips) 
Seat 4: Player4 (1990 in chips) 
Seat 5: Player5 (1245 in chips) 
Seat 6: Player2 (2400 in chips) 
Seat 8: Hero (2712 in chips) 
Seat 10: Player8 (2020 in chips) 
Player7: posts the ante 25
Player1: posts the ante 25
Player3: posts the ante 25
Player4: posts the ante 25
Player5: posts the ante 25
Player2: posts the ante 25
Hero: posts the ante 25
Player8: posts the ante 25
Player4: posts small blind 125
Player5: posts big blind 250
*** HOLE CARDS ***
Dealt to Hero [8h Js]
Player2: folds 
Hero: folds 
Player8: folds 
Player7: folds 
Player1: raises 1956 to 2206 and is all-in
Player3: calls 922 and is all-in
Player4: folds 
Player5: folds 
Uncalled bet (1284) returned to Player1
*** FLOP *** [4s 6h 5s]
*** TURN *** [4s 6h 5s] [5c]
*** RIVER *** [4s 6h 5s 5c] [9d]
*** SHOW DOWN ***
Player1: shows [Jd Qh] (a pair of Fives)
Player3: shows [Ah Ad] (two pair, Aces and Fives)
Player3 collected 2419 from pot
*** SUMMARY ***
Total pot 2419 | Rake 0 
Board [4s 6h 5s 5c 9d]
Seat 1: Player7 folded before Flop (didn't bet)
Seat 2: Player1 showed [Jd Qh] and lost with a pair of Fives
Seat 3: Player3 (button) showed [Ah Ad] and won (2419) with two pair, Aces and Fives
Seat 4: Player4 (small blind) folded before Flop
Seat 5: Player5 (big blind) folded before Flop
Seat 6: Player2 folded before Flop (didn't bet)
Seat 8: Hero folded before Flop (didn't bet)
Seat 10: Player8 folded before Flop (didn't bet)



PokerStars Game #22311473630: Tournament #999999999, $20.00+$0.80 USD Hold'em No Limit - Level VII (125/250) - 2010/06/05 18:52:55 WET [2010/06/05 13:52:55 ET]
Table '999999993 1' 10-max Seat #4 is the button
Seat 1: Player7 (1430 in chips) 
Seat 2: Player1 (1284 in chips) 
Seat 3: Player3 (2419 in chips) 
Seat 4: Player4 (1840 in chips) 
Seat 5: Player5 (970 in chips) 
Seat 6: Player2 (2375 in chips) 
Seat 8: Hero (2687 in chips) 
Seat 10: Player8 (1995 in chips) 
Player7: posts the ante 25
Player1: posts the ante 25
Player3: posts the ante 25
Player4: posts the ante 25
Player5: posts the ante 25
Player2: posts the ante 25
Hero: posts the ante 25
Player8: posts the ante 25
Player5: posts small blind 125
Player2: posts big blind 250
*** HOLE CARDS ***
Dealt to Hero [5c Ks]
Hero: folds 
Player8: folds 
Player7: folds 
Player1: raises 1009 to 1259 and is all-in
Player3: folds 
Player4: folds 
Player5: folds 
Player2: folds 
Uncalled bet (1009) returned to Player1
Player1 collected 825 from pot
*** SUMMARY ***
Total pot 825 | Rake 0 
Seat 1: Player7 folded before Flop (didn't bet)
Seat 2: Player1 collected (825)
Seat 3: Player3 folded before Flop (didn't bet)
Seat 4: Player4 (button) folded before Flop (didn't bet)
Seat 5: Player5 (small blind) folded before Flop
Seat 6: Player2 (big blind) folded before Flop
Seat 8: Hero folded before Flop (didn't bet)
Seat 10: Player8 folded before Flop (didn't bet)



PokerStars Game #21725324525: Tournament #999999999, $20.00+$0.80 USD Hold'em No Limit - Level VII (125/250) - 2010/06/05 18:53:29 WET [2010/06/05 13:53:29 ET]
Table '999999993 1' 10-max Seat #5 is the button
Seat 1: Player7 (1405 in chips) 
Seat 2: Player1 (1834 in chips) 
Seat 3: Player3 (2394 in chips) 
Seat 4: Player4 (1815 in chips) 
Seat 5: Player5 (820 in chips) 
Seat 6: Player2 (2100 in chips) 
Seat 8: Hero (2662 in chips) 
Seat 10: Player8 (1970 in chips) 
Player7: posts the ante 25
Player1: posts the ante 25
Player3: posts the ante 25
Player4: posts the ante 25
Player5: posts the ante 25
Player2: posts the ante 25
Hero: posts the ante 25
Player8: posts the ante 25
Player2: posts small blind 125
Hero: posts big blind 250
*** HOLE CARDS ***
Dealt to Hero [4s Ks]
Player8: folds 
Player4 said, "gamlet,,,A 10,,,nice suck out"
Player7: folds 
Player1: folds 
Player4 said, "you lucked out"
Player3: folds 
Player4: folds 
Player5: folds 
Player2: folds 
Uncalled bet (125) returned to Hero
Hero collected 450 from pot
Hero: doesn't show hand 
*** SUMMARY ***
Total pot 450 | Rake 0 
Seat 1: Player7 folded before Flop (didn't bet)
Seat 2: Player1 folded before Flop (didn't bet)
Seat 3: Player3 folded before Flop (didn't bet)
Seat 4: Player4 folded before Flop (didn't bet)
Seat 5: Player5 (button) folded before Flop (didn't bet)
Seat 6: Player2 (small blind) folded before Flop
Seat 8: Hero (big blind) collected (450)
Seat 10: Player8 folded before Flop (didn't bet)



PokerStars Game #25457310702: Tournament #999999999, $20.00+$0.80 USD Hold'em No Limit - Level VII (125/250) - 2010/06/05 18:53:56 WET [2010/06/05 13:53:56 ET]
Table '999999993 1' 10-max Seat #6 is the button
Seat 1: Player7 (1380 in chips) 
Seat 2: Player1 (1809 in chips) 
Seat 3: Player3 (2369 in chips) 
Seat 4: Player4 (1790 in chips) 
Seat 5: Player5 (795 in chips) 
Seat 6: Player2 (1950 in chips) 
Seat 8: Hero (2962 in chips) 
Seat 10: Player8 (1945 in chips) 
Player7: posts the ante 25
Player1: posts the ante 25
Player3: posts the ante 25
Player4: posts the ante 25
Player5: posts the ante 25
Player2: posts the ante 25
Hero: posts the ante 25
Player8: posts the ante 25
Hero: posts small blind 125
Player8: posts big blind 250
*** HOLE CARDS ***
Dealt to Hero [3d 7s]
Player7: folds 
Player1: folds 
Player3: folds 
Player4: folds 
Player5: folds 
Player2: folds 
Hero: raises 2687 to 2937 and is all-in
Player8: folds 
Uncalled bet (2687) returned to Hero
Hero collected 700 from pot
Hero: doesn't show hand 
*** SUMMARY ***
Total pot 700 | Rake 0 
Seat 1: Player7 folded before Flop (didn't bet)
Seat 2: Player1 folded before Flop (didn't bet)
Seat 3: Player3 folded before Flop (didn't bet)
Seat 4: Player4 folded before Flop (didn't bet)
Seat 5: Player5 folded before Flop (didn't bet)
Seat 6: Player2 (button) folded before Flop (didn't bet)
Seat 8: Hero (small blind) collected (700)
Seat 10: Player8 (big blind) folded before Flop



PokerStars Game #16450285998: Tournament #999999999, $20.00+$0.80 USD Hold'em No Limit - Level VII (125/250) - 2010/06/05 18:54:21 WET [2010/06/05 13:54:21 ET]
Table '999999993 1' 10-max Seat #8 is the button
Seat 1: Player7 (1355 in chips) 
Seat 2: Player1 (1784 in chips) 
Seat 3: Player3 (2344 in chips) 
Seat 4: Player4 (1765 in chips) 
Seat 5: Player5 (770 in chips) 
Seat 6: Player2 (1925 in chips) 
Seat 8: Hero (3387 in chips) 
Seat 10: Player8 (1670 in chips) 
Player7: posts the ante 25
Player1: posts the ante 25
Player3: posts the ante 25
Player4: posts the ante 25
Player5: posts the ante 25
Player2: posts the ante 25
Hero: posts the ante 25
Player8: posts the ante 25
Player8: posts small blind 125
Player7: posts big blind 250
*** HOLE CARDS ***
Dealt to Hero [2d As]
Player1: raises 1509 to 1759 and is all-in
Player3: folds 
Player4: folds 
Player5: calls 745 and is all-in
Player2: folds 
Hero: folds 
Player8: folds 
Player7: folds 
Uncalled bet (1014) returned to Player1
*** FLOP *** [3c 2c Ks]
*** TURN *** [3c 2c Ks] [7c]
*** RIVER *** [3c 2c Ks 7c] [5s]
*** SHOW DOWN ***
Player1: shows [Tc Ac] (a flush, Ace high)
Player5: shows [Ts Td] (a pair of Tens)
Player1 collected 2065 from pot
Player5 finished the tournament in 8th place
*** SUMMARY ***
Total pot 2065 | Rake 0 
Board [3c 2c Ks 7c 5s]
Seat 1: Player7 (big blind) folded before Flop
Seat 2: Player1 showed [Tc Ac] and won (2065) with a flush, Ace high
Seat 3: Player3 folded before Flop (didn't bet)
Seat 4: Player4 folded before Flop (didn't bet)
Seat 5: Player5 showed [Ts Td] and lost with a pair of Tens
Seat 6: Player2 folded before Flop (didn't bet)
Seat 8: Hero (button) folded before Flop (didn't bet)
Seat 10: Player8 (small blind) folded before Flop



PokerStars Game #29432277481: Tournament #999999999, $20.00+$0.80 USD Hold'em No Limit - Level VII (125/250) - 2010/06/05 18:55:03 WET [2010/06/05 13:55:03 ET]
Table '999999993 1' 10-max Seat #10 is the button
Seat 1: Player7 (1080 in chips) 
Seat 2: Player1 (3079 in chips) 
Seat 3: Player3 (2319 in chips) 
Seat 4: Player4 (1740 in chips) 
Seat 6: Player2 (1900 in chips) 
Seat 8: Hero (3362 in chips) 
Seat 10: Player8 (1520 in chips) 
Player7: posts the ante 25
Player1: posts the ante 25
Player3: posts the ante 25
Player4: posts the ante 25
Player2: posts the ante 25
Hero: posts the ante 25
Player8: posts the ante 25
Player7: posts small blind 125
Player1: posts big blind 250
*** HOLE CARDS ***
Dealt to Hero [Qh 2s]
Player3: raises 250 to 500
Player4: folds 
Player2: folds 
Hero: folds 
Player8: folds 
Player7: folds 
Player1: folds 
Uncalled bet (250) returned to Player3
Player3 collected 800 from pot
Player3: doesn't show hand 
*** SUMMARY ***
Total pot 800 | Rake 0 
Seat 1: Player7 (small blind) folded before Flop
Seat 2: Player1 (big blind) folded before Flop
Seat 3: Player3 collected (800)
Seat 4: Player4 folded before Flop (didn't bet)
Seat 6: Player2 folded before Flop (didn't bet)
Seat 8: Hero folded before Flop (didn't bet)
Seat 10: Player8 (button) folded before Flop (didn't bet)



PokerStars Game #14663167952: Tournament #999999999, $20.00+$0.80 USD Hold'em No Limit - Level VII (125/250) - 2010/06/05 18:55:21 WET [2010/06/05 13:55:21 ET]
Table '999999993 1' 10-max Seat #1 is the button
Seat 1: Player7 (930 in chips) 
Seat 2: Player1 (2804 in chips) 
Seat 3: Player3 (2844 in chips) 
Seat 4: Player4 (1715 in chips) 
Seat 6: Player2 (1875 in chips) 
Seat 8: Hero (3337 in chips) 
Seat 10: Player8 (1495 in chips) 
Player7: posts the ante 25
Player1: posts the ante 25
Player3: posts the ante 25
Player4: posts the ante 25
Player2: posts the ante 25
Hero: posts the ante 25
Player8: posts the ante 25
Player1: posts small blind 125
Player3: posts big blind 250
*** HOLE CARDS ***
Dealt to Hero [Ad Ts]
Player4: folds 
Player2: folds 
Hero: raises 500 to 750
Player8: folds 
Player7: raises 155 to 905 and is all-in
Player1: folds 
Player3: folds 
Hero: calls 155
*** FLOP *** [5h 7h As]
*** TURN *** [5h 7h As] [8h]
*** RIVER *** [5h 7h As 8h] [Jh]
*** SHOW DOWN ***
Hero: shows [Ad Ts] (a pair of Aces)
Player7: shows [Kh Kc] (a flush, King high)
Player7 collected 2360 from pot
*** SUMMARY ***
Total pot 2360 | Rake 0 
Board [5h 7h As 8h Jh]
Seat 1: Player7 (button) showed [Kh Kc] and won (2360) with a flush, King high
Seat 2: Player1 (small blind) folded before Flop
Seat 3: Player3 (big blind) folded before Flop
Seat 4: Player4 folded before Flop (didn't bet)
Seat 6: Player2 folded before Flop (didn't bet)
Seat 8: Hero showed [Ad Ts] and lost with a pair of Aces
Seat 10: Player8 folded before Flop (didn't bet)



PokerStars Game #25038217401: Tournament #999999999, $20.00+$0.80 USD Hold'em No Limit - Level VIII (150/300) - 2010/06/05 18:56:07 WET [2010/06/05 13:56:07 ET]
Table '999999993 1' 10-max Seat #2 is the button
Seat 1: Player7 (2360 in chips) 
Seat 2: Player1 (2654 in chips) 
Seat 3: Player3 (2569 in chips) 
Seat 4: Player4 (1690 in chips) 
Seat 6: Player2 (1850 in chips) 
Seat 8: Hero (2407 in chips) 
Seat 10: Player8 (1470 in chips) 
Player7: posts the ante 30
Player1: posts the ante 30
Player3: posts the ante 30
Player4: posts the ante 30
Player2: posts the ante 30
Hero: posts the ante 30
Player8: posts the ante 30
Player3: posts small blind 150
Player4: posts big blind 300
*** HOLE CARDS ***
Dealt to Hero [As Kc]
Player2: folds 
Hero: raises 2077 to 2377 and is all-in
Player8: folds 
Player7: folds 
Player1: folds 
Player3: folds 
Player4: folds 
Uncalled bet (2077) returned to Hero
Hero collected 960 from pot
Hero: doesn't show hand 
*** SUMMARY ***
Total pot 960 | Rake 0 
Seat 1: Player7 folded before Flop (didn't bet)
Seat 2: Player1 (button) folded before Flop (didn't bet)
Seat 3: Player3 (small blind) folded before Flop
Seat 4: Player4 (big blind) folded before Flop
Seat 6: Player2 folded before Flop (didn't bet)
Seat 8: Hero collected (960)
Seat 10: Player8 folded before Flop (didn't bet)



PokerStars Game #16107184333: Tournament #999999999, $20.00+$0.80 USD Hold'em No Limit - Level VIII (150/300) - 2010/06/05 18:56:23 WET [2010/06/05 13:56:23 ET]
Table '999999993 1' 10-max Seat #3 is the button
Seat 1: Player7 (2330 in chips) 
Seat 2: Player1 (2624 in chips) 
Seat 3: Player3 (2389 in chips) 
Seat 4: Player4 (1360 in chips) 
Seat 6: Player2 (1820 in chips) 
Seat 8: Hero (3037 in chips) 
Seat 10: Player8 (1440 in chips) 
Player7: posts the ante 30
Player1: posts the ante 30
Player3: posts the ante 30
Player4: posts the ante 30
Player2: posts the ante 30
Hero: posts the ante 30
Player8: posts the ante 30
Player4: posts small blind 150
Player2: posts big blind 300
*** HOLE CARDS ***
Dealt to Hero [2s 2d]
Hero: raises 2707 to 3007 and is all-in
Player8: folds 
Player7: folds 
Player1: folds 
Player3: folds 
Player4: folds 
Player2: folds 
Uncalled bet (2707) returned to Hero
Hero collected 960 from pot
Hero: doesn't show hand 
*** SUMMARY ***
Total pot 960 | Rake 0 
Seat 1: Player7 folded before Flop (didn't bet)
Seat 2: Player1 folded before Flop (didn't bet)
Seat 3: Player3 (button) folded before Flop (didn't bet)
Seat 4: Player4 (small blind) folded before Flop
Seat 6: Player2 (big blind) folded before Flop
Seat 8: Hero collected (960)
Seat 10: Player8 folded before Flop (didn't bet)



PokerStars Game #97952060720: Tournament #999999999, $20.00+$0.80 USD Hold'em No Limit - Level VIII (150/300) - 2010/06/05 18:56:37 WET [2010/06/05 13:56:37 ET]
Table '999999993 1' 10-max Seat #4 is the button
Seat 1: Player7 (2300 in chips) 
Seat 2: Player1 (2594 in chips) 
Seat 3: Player3 (2359 in chips) 
Seat 4: Player4 (1180 in chips) 
Seat 6: Player2 (1490 in chips) 
Seat 8: Hero (3667 in chips) 
Seat 10: Player8 (1410 in chips) 
Player7: posts the ante 30
Player1: posts the ante 30
Player3: posts the ante 30
Player4: posts the ante 30
Player2: posts the ante 30
Hero: posts the ante 30
Player8: posts the ante 30
Player2: posts small blind 150
Hero: posts big blind 300
*** HOLE CARDS ***
Dealt to Hero [Th Td]
Player8: folds 
Player7: folds 
Player1: raises 2264 to 2564 and is all-in
Player3: folds 
Player4: folds 
Player2: folds 
Hero: calls 2264
*** FLOP *** [Ad Kc 7c]
*** TURN *** [Ad Kc 7c] [9s]
*** RIVER *** [Ad Kc 7c 9s] [Qs]
*** SHOW DOWN ***
Hero: shows [Th Td] (a pair of Tens)
Player1: shows [Tc 9c] (a pair of Nines)
Hero collected 5488 from pot
Player1 finished the tournament in 7th place
*** SUMMARY ***
Total pot 5488 | Rake 0 
Board [Ad Kc 7c 9s Qs]
Seat 1: Player7 folded before Flop (didn't bet)
Seat 2: Player1 showed [Tc 9c] and lost with a pair of Nines
Seat 3: Player3 folded before Flop (didn't bet)
Seat 4: Player4 (button) folded before Flop (didn't bet)
Seat 6: Player2 (small blind) folded before Flop
Seat 8: Hero (big blind) showed [Th Td] and won (5488) with a pair of Tens
Seat 10: Player8 folded before Flop (didn't bet)



PokerStars Game #32542183913: Tournament #999999999, $20.00+$0.80 USD Hold'em No Limit - Level VIII (150/300) - 2010/06/05 18:57:14 WET [2010/06/05 13:57:14 ET]
Table '999999993 1' 10-max Seat #6 is the button
Seat 1: Player7 (2270 in chips) 
Seat 3: Player3 (2329 in chips) 
Seat 4: Player4 (1150 in chips) 
Seat 6: Player2 (1310 in chips) 
Seat 8: Hero (6561 in chips) 
Seat 10: Player8 (1380 in chips) 
Player7: posts the ante 30
Player3: posts the ante 30
Player4: posts the ante 30
Player2: posts the ante 30
Hero: posts the ante 30
Player8: posts the ante 30
Hero: posts small blind 150
Player8: posts big blind 300
*** HOLE CARDS ***
Dealt to Hero [6d 7s]
Player7: folds 
Player3: folds 
Player4: folds 
Player2: folds 
Hero: raises 1800 to 2100
Player8: folds 
Uncalled bet (1800) returned to Hero
Hero collected 780 from pot
Hero: doesn't show hand 
*** SUMMARY ***
Total pot 780 | Rake 0 
Seat 1: Player7 folded before Flop (didn't bet)
Seat 3: Player3 folded before Flop (didn't bet)
Seat 4: Player4 folded before Flop (didn't bet)
Seat 6: Player2 (button) folded before Flop (didn't bet)
Seat 8: Hero (small blind) collected (780)
Seat 10: Player8 (big blind) folded before Flop



PokerStars Game #13633150393: Tournament #999999999, $20.00+$0.80 USD Hold'em No Limit - Level VIII (150/300) - 2010/06/05 18:57:47 WET [2010/06/05 13:57:47 ET]
Table '999999993 1' 10-max Seat #8 is the button
Seat 1: Player7 (2240 in chips) 
Seat 3: Player3 (2299 in chips) 
Seat 4: Player4 (1120 in chips) 
Seat 6: Player2 (1280 in chips) 
Seat 8: Hero (7011 in chips) 
Seat 10: Player8 (1050 in chips) 
Player7: posts the ante 30
Player3: posts the ante 30
Player4: posts the ante 30
Player2: posts the ante 30
Hero: posts the ante 30
Player8: posts the ante 30
Player8: posts small blind 150
Player7: posts big blind 300
*** HOLE CARDS ***
Dealt to Hero [Kc Jc]
Player3: raises 300 to 600
Player4: folds 
Player2: folds 
Hero: folds 
Player8: folds 
Player7: folds 
Uncalled bet (300) returned to Player3
Player3 collected 930 from pot
Player3: doesn't show hand 
*** SUMMARY ***
Total pot 930 | Rake 0 
Seat 1: Player7 (big blind) folded before Flop
Seat 3: Player3 collected (930)
Seat 4: Player4 folded before Flop (didn't bet)
Seat 6: Player2 folded before Flop (didn't bet)
Seat 8: Hero (button) folded before Flop (didn't bet)
Seat 10: Player8 (small blind) folded before Flop



PokerStars Game #29869218603: Tournament #999999999, $20.00+$0.80 USD Hold'em No Limit - Level VIII (150/300) - 2010/06/05 18:58:09 WET [2010/06/05 13:58:09 ET]
Table '999999993 1' 10-max Seat #10 is the button
Seat 1: Player7 (1910 in chips) 
Seat 3: Player3 (2899 in chips) 
Seat 4: Player4 (1090 in chips) 
Seat 6: Player2 (1250 in chips) 
Seat 8: Hero (6981 in chips) 
Seat 10: Player8 (870 in chips) 
Player7: posts the ante 30
Player3: posts the ante 30
Player4: posts the ante 30
Player2: posts the ante 30
Hero: posts the ante 30
Player8: posts the ante 30
Player7: posts small blind 150
Player3: posts big blind 300
*** HOLE CARDS ***
Dealt to Hero [9c 4d]
Player4: raises 760 to 1060 and is all-in
Player2: folds 
Hero: folds 
Player8: folds 
Player7: folds 
Player3: folds 
Uncalled bet (760) returned to Player4
Player4 collected 930 from pot
*** SUMMARY ***
Total pot 930 | Rake 0 
Seat 1: Player7 (small blind) folded before Flop
Seat 3: Player3 (big blind) folded before Flop
Seat 4: Player4 collected (930)
Seat 6: Player2 folded before Flop (didn't bet)
Seat 8: Hero folded before Flop (didn't bet)
Seat 10: Player8 (button) folded before Flop (didn't bet)



PokerStars Game #31933493206: Tournament #999999999, $20.00+$0.80 USD Hold'em No Limit - Level VIII (150/300) - 2010/06/05 18:58:34 WET [2010/06/05 13:58:34 ET]
Table '999999993 1' 10-max Seat #1 is the button
Seat 1: Player7 (1730 in chips) 
Seat 3: Player3 (2569 in chips) 
Seat 4: Player4 (1690 in chips) 
Seat 6: Player2 (1220 in chips) 
Seat 8: Hero (6951 in chips) 
Seat 10: Player8 (840 in chips) 
Player7: posts the ante 30
Player3: posts the ante 30
Player4: posts the ante 30
Player2: posts the ante 30
Hero: posts the ante 30
Player8: posts the ante 30
Player3: posts small blind 150
Player4: posts big blind 300
*** HOLE CARDS ***
Dealt to Hero [4d Ac]
Player2: folds 
Hero: raises 600 to 900
Player8: folds 
Player7: folds 
Player3: folds 
Player4: folds 
Uncalled bet (600) returned to Hero
Hero collected 930 from pot
Hero: doesn't show hand 
*** SUMMARY ***
Total pot 930 | Rake 0 
Seat 1: Player7 (button) folded before Flop (didn't bet)
Seat 3: Player3 (small blind) folded before Flop
Seat 4: Player4 (big blind) folded before Flop
Seat 6: Player2 folded before Flop (didn't bet)
Seat 8: Hero collected (930)
Seat 10: Player8 folded before Flop (didn't bet)



PokerStars Game #27455183722: Tournament #999999999, $20.00+$0.80 USD Hold'em No Limit - Level VIII (150/300) - 2010/06/05 18:58:56 WET [2010/06/05 13:58:56 ET]
Table '999999993 1' 10-max Seat #3 is the button
Seat 1: Player7 (1700 in chips) 
Seat 3: Player3 (2389 in chips) 
Seat 4: Player4 (1360 in chips) 
Seat 6: Player2 (1190 in chips) 
Seat 8: Hero (7551 in chips) 
Seat 10: Player8 (810 in chips) 
Player7: posts the ante 30
Player3: posts the ante 30
Player4: posts the ante 30
Player2: posts the ante 30
Hero: posts the ante 30
Player8: posts the ante 30
Player4: posts small blind 150
Player2: posts big blind 300
*** HOLE CARDS ***
Dealt to Hero [9d 6s]
Hero: folds 
Player8: raises 450 to 750
Player7: folds 
Player3: folds 
Player4: folds 
Player2: folds 
Uncalled bet (450) returned to Player8
Player8 collected 930 from pot
Player8: doesn't show hand 
*** SUMMARY ***
Total pot 930 | Rake 0 
Seat 1: Player7 folded before Flop (didn't bet)
Seat 3: Player3 (button) folded before Flop (didn't bet)
Seat 4: Player4 (small blind) folded before Flop
Seat 6: Player2 (big blind) folded before Flop
Seat 8: Hero folded before Flop (didn't bet)
Seat 10: Player8 collected (930)



PokerStars Game #12858227913: Tournament #999999999, $20.00+$0.80 USD Hold'em No Limit - Level VIII (150/300) - 2010/06/05 18:59:15 WET [2010/06/05 13:59:15 ET]
Table '999999993 1' 10-max Seat #4 is the button
Seat 1: Player7 (1670 in chips) 
Seat 3: Player3 (2359 in chips) 
Seat 4: Player4 (1180 in chips) 
Seat 6: Player2 (860 in chips) 
Seat 8: Hero (7521 in chips) 
Seat 10: Player8 (1410 in chips) 
Player7: posts the ante 30
Player3: posts the ante 30
Player4: posts the ante 30
Player2: posts the ante 30
Hero: posts the ante 30
Player8: posts the ante 30
Player2: posts small blind 150
Hero: posts big blind 300
*** HOLE CARDS ***
Dealt to Hero [Kd 7c]
Player8: folds 
Player7: folds 
Player3: folds 
Player4: folds 
Player2: raises 530 to 830 and is all-in
Hero: calls 530
*** FLOP *** [7s Kc 3s]
*** TURN *** [7s Kc 3s] [9c]
*** RIVER *** [7s Kc 3s 9c] [6s]
*** SHOW DOWN ***
Player2: shows [Ah 6c] (a pair of Sixes)
Hero: shows [Kd 7c] (two pair, Kings and Sevens)
Hero collected 1840 from pot
Player2 finished the tournament in 6th place
Player7 finished the tournament in 1st place and received $40.00.
Player3 finished the tournament in 1st place and received $40.00.
Player4 finished the tournament in 1st place and received $40.00.
Hero finished the tournament in 1st place and received $40.00.
Player8 finished the tournament in 1st place and received $40.00.
*** SUMMARY ***
Total pot 1840 | Rake 0 
Board [7s Kc 3s 9c 6s]
Seat 1: Player7 folded before Flop (didn't bet)
Seat 3: Player3 folded before Flop (didn't bet)
Seat 4: Player4 (button) folded before Flop (didn't bet)
Seat 6: Player2 (small blind) showed [Ah 6c] and lost with a pair of Sixes
Seat 8: Hero (big blind) showed [Kd 7c] and won (1840) with two pair, Kings and Sevens
Seat 10: Player8 folded before Flop (didn't bet)




