Poker Hand #TM247771977: Tournament #5259595, Daily Special $250 Hold'em No Limit - Level2 (60/120) - 2020/06/02 19:17:33
Table '6' 8-max Seat #1 is the button
Seat 1: Hero (10,000 in chips)
Seat 2: a9055bd5 (23,639 in chips)
Hero: posts the ante 18
a9055bd5: posts the ante 18
Hero: posts small blind 60
a9055bd5: posts big blind 120
*** HOLE CARDS ***
Dealt to Hero [Qh Jh]
Dealt to a9055bd5 
Hero: raises 156 to 276
a9055bd5: calls 156
*** FLOP *** [4h Ts Qs]
a9055bd5: checks
Hero: bets 294
a9055bd5: folds
Uncalled bet (294) returned to Hero
*** SHOWDOWN ***
Hero collected 588 from pot
*** SUMMARY ***
Total pot 588
Board [4h Ts Qs]
Seat 1: Hero (small blind) won (588)
Seat 2: a9055bd5 (big blind) folded on the Flop


Poker Hand #TM247772064: Tournament #5259595, Daily Special $250 Hold'em No Limit - Level2 (60/120) - 2020/06/02 19:18:10
Table '6' 8-max Seat #2 is the button
Seat 1: Hero (10,294 in chips)
Seat 2: a9055bd5 (23,345 in chips)
Hero: posts the ante 18
a9055bd5: posts the ante 18
a9055bd5: posts small blind 60
Hero: posts big blind 120
*** HOLE CARDS ***
Dealt to Hero [8h 3h]
Dealt to a9055bd5 
a9055bd5: raises 120 to 240
Hero: calls 120
*** FLOP *** [6d 3s 9d]
Hero: checks
a9055bd5: checks
*** TURN *** [6d 3s 9d] [2d]
Hero: checks
a9055bd5: checks
*** RIVER *** [6d 3s 9d 2d] [7h]
Hero: checks
a9055bd5: checks
a9055bd5: shows [Jc Ad] (Ace-High)
Hero: shows [3h 8h] (Pair of Treys)
*** SHOWDOWN ***
Hero collected 516 from pot
*** SUMMARY ***
Total pot 516
Board [6d 3s 9d 2d 7h]
Seat 1: Hero (big blind) showed [8h 3h] and won (516) with Pair of Treys
Seat 2: a9055bd5 (small blind) showed [Ad Jc] and lost with Ace-High


Poker Hand #TM247772164: Tournament #5259595, Daily Special $250 Hold'em No Limit - Level2 (60/120) - 2020/06/02 19:18:52
Table '6' 8-max Seat #1 is the button
Seat 1: Hero (10,552 in chips)
Seat 2: a9055bd5 (23,087 in chips)
Seat 3: 5d46d288 (12,676 in chips)
Seat 4: 326ed8a3 (9,982 in chips)
Seat 5: d6d937c9 (3,976 in chips)
Seat 6: ae0045c4 (11,530 in chips)
326ed8a3: posts the ante 18
ae0045c4: posts the ante 18
5d46d288: posts the ante 18
a9055bd5: posts the ante 18
d6d937c9: posts the ante 18
Hero: posts the ante 18
a9055bd5: posts small blind 60
5d46d288: posts big blind 120
*** HOLE CARDS ***
Dealt to Hero [Jd 4s]
Dealt to a9055bd5 
Dealt to 5d46d288 
Dealt to 326ed8a3 
Dealt to d6d937c9 
Dealt to ae0045c4 
326ed8a3: folds
d6d937c9: folds
ae0045c4: raises 180 to 300
Hero: folds
a9055bd5: folds
5d46d288: calls 180
*** FLOP *** [As 8c Kd]
5d46d288: checks
ae0045c4: bets 192
5d46d288: folds
Uncalled bet (192) returned to ae0045c4
*** SHOWDOWN ***
ae0045c4 collected 768 from pot
*** SUMMARY ***
Total pot 768
Board [As 8c Kd]
Seat 1: Hero (button) folded before Flop
Seat 2: a9055bd5 (small blind) folded before Flop
Seat 3: 5d46d288 (big blind) folded on the Flop
Seat 4: 326ed8a3 folded before Flop
Seat 5: d6d937c9 folded before Flop
Seat 6: ae0045c4 won (768)


Poker Hand #TM247772256: Tournament #5259595, Daily Special $250 Hold'em No Limit - Level2 (60/120) - 2020/06/02 19:19:31
Table '6' 8-max Seat #2 is the button
Seat 1: Hero (10,534 in chips)
Seat 2: a9055bd5 (23,009 in chips)
Seat 3: 5d46d288 (12,358 in chips)
Seat 4: 326ed8a3 (9,964 in chips)
Seat 5: d6d937c9 (3,958 in chips)
Seat 6: ae0045c4 (11,980 in chips)
326ed8a3: posts the ante 18
ae0045c4: posts the ante 18
5d46d288: posts the ante 18
a9055bd5: posts the ante 18
d6d937c9: posts the ante 18
Hero: posts the ante 18
5d46d288: posts small blind 60
326ed8a3: posts big blind 120
*** HOLE CARDS ***
Dealt to Hero [Ks Qd]
Dealt to a9055bd5 
Dealt to 5d46d288 
Dealt to 326ed8a3 
Dealt to d6d937c9 
Dealt to ae0045c4 
d6d937c9: folds
ae0045c4: folds
Hero: raises 180 to 300
a9055bd5: folds
5d46d288: folds
326ed8a3: calls 180
*** FLOP *** [Th 3d 7c]
326ed8a3: checks
Hero: bets 253
326ed8a3: calls 253
*** TURN *** [Th 3d 7c] [2s]
326ed8a3: checks
Hero: checks
*** RIVER *** [Th 3d 7c 2s] [2c]
326ed8a3: bets 841
Hero: calls 841
326ed8a3: shows [8s Tc] (Pair of Tens and Pair of Twos)
Hero: shows [Ks Qd] (Pair of Twos)
*** SHOWDOWN ***
326ed8a3 collected 2,956 from pot
*** SUMMARY ***
Total pot 2,956
Board [Th 3d 7c 2s 2c]
Seat 1: Hero showed [Ks Qd] and lost with Pair of Twos
Seat 2: a9055bd5 (button) folded before Flop
Seat 3: 5d46d288 (small blind) folded before Flop
Seat 4: 326ed8a3 (big blind) showed [Tc 8s] and won (2,956) with Pair of Tens and Pair of Twos
Seat 5: d6d937c9 folded before Flop
Seat 6: ae0045c4 folded before Flop


Poker Hand #TM247772436: Tournament #5259595, Daily Special $250 Hold'em No Limit - Level2 (60/120) - 2020/06/02 19:20:48
Table '6' 8-max Seat #3 is the button
Seat 1: Hero (9,122 in chips)
Seat 2: a9055bd5 (22,991 in chips)
Seat 3: 5d46d288 (12,280 in chips)
Seat 4: 326ed8a3 (11,508 in chips)
Seat 5: d6d937c9 (3,940 in chips)
Seat 6: ae0045c4 (11,962 in chips)
326ed8a3: posts the ante 18
ae0045c4: posts the ante 18
5d46d288: posts the ante 18
a9055bd5: posts the ante 18
d6d937c9: posts the ante 18
Hero: posts the ante 18
326ed8a3: posts small blind 60
d6d937c9: posts big blind 120
*** HOLE CARDS ***
Dealt to Hero [Td 5c]
Dealt to a9055bd5 
Dealt to 5d46d288 
Dealt to 326ed8a3 
Dealt to d6d937c9 
Dealt to ae0045c4 
ae0045c4: folds
Hero: folds
a9055bd5: folds
5d46d288: folds
326ed8a3: calls 60
d6d937c9: checks
*** FLOP *** [4d 3h 8h]
326ed8a3: bets 120
d6d937c9: calls 120
*** TURN *** [4d 3h 8h] [9h]
326ed8a3: checks
d6d937c9: checks
*** RIVER *** [4d 3h 8h 9h] [7h]
326ed8a3: checks
d6d937c9: bets 156
326ed8a3: folds
Uncalled bet (156) returned to d6d937c9
*** SHOWDOWN ***
d6d937c9 collected 588 from pot
*** SUMMARY ***
Total pot 588
Board [4d 3h 8h 9h 7h]
Seat 1: Hero folded before Flop
Seat 2: a9055bd5 folded before Flop
Seat 3: 5d46d288 (button) folded before Flop
Seat 4: 326ed8a3 (small blind) folded on the River
Seat 5: d6d937c9 (big blind) won (588)
Seat 6: ae0045c4 folded before Flop


Poker Hand #TM247772760: Tournament #5259595, Daily Special $250 Hold'em No Limit - Level2 (60/120) - 2020/06/02 19:23:13
Table '6' 8-max Seat #4 is the button
Seat 1: Hero (9,104 in chips)
Seat 2: a9055bd5 (22,973 in chips)
Seat 3: 5d46d288 (12,262 in chips)
Seat 4: 326ed8a3 (11,250 in chips)
Seat 5: d6d937c9 (4,270 in chips)
Seat 6: ae0045c4 (11,944 in chips)
Seat 7: c4607254 (9,645 in chips)
Seat 8: 4e885360 (19,463 in chips)
326ed8a3: posts the ante 18
4e885360: posts the ante 18
ae0045c4: posts the ante 18
5d46d288: posts the ante 18
a9055bd5: posts the ante 18
d6d937c9: posts the ante 18
c4607254: posts the ante 18
Hero: posts the ante 18
d6d937c9: posts small blind 60
ae0045c4: posts big blind 120
*** HOLE CARDS ***
Dealt to Hero [Jc 9d]
Dealt to a9055bd5 
Dealt to 5d46d288 
Dealt to 326ed8a3 
Dealt to d6d937c9 
Dealt to ae0045c4 
Dealt to c4607254 
Dealt to 4e885360 
c4607254: folds
4e885360: raises 180 to 300
Hero: folds
a9055bd5: folds
5d46d288: raises 780 to 1,080
326ed8a3: folds
d6d937c9: folds
ae0045c4: folds
4e885360: calls 780
*** FLOP *** [5s 4d 8d]
4e885360: checks
5d46d288: checks
*** TURN *** [5s 4d 8d] [8c]
4e885360: checks
5d46d288: checks
*** RIVER *** [5s 4d 8d 8c] [5c]
4e885360: checks
5d46d288: checks
4e885360: shows [Ts 9s] (Pair of Eights and Pair of Fives)
5d46d288: shows [Ah Jh] (Pair of Eights and Pair of Fives)
*** SHOWDOWN ***
5d46d288 collected 2,484 from pot
*** SUMMARY ***
Total pot 2,484
Board [5s 4d 8d 8c 5c]
Seat 1: Hero folded before Flop
Seat 2: a9055bd5 folded before Flop
Seat 3: 5d46d288 showed [Ah Jh] and won (2,484) with Pair of Eights and Pair of Fives
Seat 4: 326ed8a3 (button) folded before Flop
Seat 5: d6d937c9 (small blind) folded before Flop
Seat 6: ae0045c4 (big blind) folded before Flop
Seat 7: c4607254 folded before Flop
Seat 8: 4e885360 showed [Ts 9s] and lost with Pair of Eights and Pair of Fives


Poker Hand #TM247773056: Tournament #5259595, Daily Special $250 Hold'em No Limit - Level3 (80/160) - 2020/06/02 19:25:21
Table '6' 8-max Seat #5 is the button
Seat 1: Hero (9,086 in chips)
Seat 3: 5d46d288 (13,648 in chips)
Seat 4: 326ed8a3 (11,232 in chips)
Seat 5: d6d937c9 (4,192 in chips)
Seat 7: c4607254 (9,627 in chips)
Seat 8: 4e885360 (18,365 in chips)
326ed8a3: posts the ante 18
4e885360: posts the ante 18
5d46d288: posts the ante 18
d6d937c9: posts the ante 18
c4607254: posts the ante 18
Hero: posts the ante 18
c4607254: posts small blind 60
4e885360: posts big blind 120
*** HOLE CARDS ***
Dealt to Hero [9h 5c]
Dealt to 5d46d288 
Dealt to 326ed8a3 
Dealt to d6d937c9 
Dealt to c4607254 
Dealt to 4e885360 
Hero: folds
5d46d288: raises 180 to 300
326ed8a3: folds
d6d937c9: folds
c4607254: folds
4e885360: calls 180
*** FLOP *** [Kd 7s As]
4e885360: checks
5d46d288: checks
*** TURN *** [Kd 7s As] [6d]
4e885360: bets 499
5d46d288: calls 499
*** RIVER *** [Kd 7s As 6d] [6s]
4e885360: bets 1,088
5d46d288: calls 1,088
4e885360: shows [9c Ah] (Pair of Aces and Pair of Sixes)
5d46d288: shows [Ks Jc] (Pair of Kings and Pair of Sixes)
*** SHOWDOWN ***
4e885360 collected 3,942 from pot
*** SUMMARY ***
Total pot 3,942
Board [Kd 7s As 6d 6s]
Seat 1: Hero folded before Flop
Seat 3: 5d46d288 showed [Ks Jc] and lost with Pair of Kings and Pair of Sixes
Seat 4: 326ed8a3 folded before Flop
Seat 5: d6d937c9 (button) folded before Flop
Seat 7: c4607254 (small blind) folded before Flop
Seat 8: 4e885360 (big blind) showed [Ah 9c] and won (3,942) with Pair of Aces and Pair of Sixes


Poker Hand #TM247773296: Tournament #5259595, Daily Special $250 Hold'em No Limit - Level3 (80/160) - 2020/06/02 19:27:05
Table '6' 8-max Seat #7 is the button
Seat 1: Hero (9,068 in chips)
Seat 3: 5d46d288 (11,743 in chips)
Seat 4: 326ed8a3 (11,214 in chips)
Seat 5: d6d937c9 (4,174 in chips)
Seat 7: c4607254 (9,549 in chips)
Seat 8: 4e885360 (20,402 in chips)
326ed8a3: posts the ante 25
4e885360: posts the ante 25
5d46d288: posts the ante 25
d6d937c9: posts the ante 25
c4607254: posts the ante 25
Hero: posts the ante 25
4e885360: posts small blind 80
Hero: posts big blind 160
*** HOLE CARDS ***
Dealt to Hero [Kd Jh]
Dealt to 5d46d288 
Dealt to 326ed8a3 
Dealt to d6d937c9 
Dealt to c4607254 
Dealt to 4e885360 
5d46d288: raises 320 to 480
326ed8a3: folds
d6d937c9: folds
c4607254: folds
4e885360: folds
Hero: calls 320
*** FLOP *** [9s Qh 3s]
Hero: checks
5d46d288: bets 393
Hero: calls 393
*** TURN *** [9s Qh 3s] [Qc]
Hero: bets 812
5d46d288: calls 812
*** RIVER *** [9s Qh 3s Qc] [Ks]
Hero: checks
5d46d288: bets 2,860
Hero: calls 2,860
5d46d288: shows [Kc Kh] (Kings Full over Queens)
Hero: shows [Jh Kd] (Pair of Kings and Pair of Queens)
*** SHOWDOWN ***
5d46d288 collected 9,320 from pot
*** SUMMARY ***
Total pot 9,320
Board [9s Qh 3s Qc Ks]
Seat 1: Hero (big blind) showed [Kd Jh] and lost with Pair of Kings and Pair of Queens
Seat 3: 5d46d288 showed [Kh Kc] and won (9,320) with Kings Full over Queens
Seat 4: 326ed8a3 folded before Flop
Seat 5: d6d937c9 folded before Flop
Seat 7: c4607254 (button) folded before Flop
Seat 8: 4e885360 (small blind) folded before Flop


Poker Hand #TM247773480: Tournament #5259595, Daily Special $250 Hold'em No Limit - Level3 (80/160) - 2020/06/02 19:28:29
Table '6' 8-max Seat #8 is the button
Seat 1: Hero (4,498 in chips)
Seat 3: 5d46d288 (16,493 in chips)
Seat 4: 326ed8a3 (11,189 in chips)
Seat 5: d6d937c9 (4,149 in chips)
Seat 7: c4607254 (9,524 in chips)
Seat 8: 4e885360 (20,297 in chips)
326ed8a3: posts the ante 25
4e885360: posts the ante 25
5d46d288: posts the ante 25
d6d937c9: posts the ante 25
c4607254: posts the ante 25
Hero: posts the ante 25
Hero: posts small blind 80
5d46d288: posts big blind 160
*** HOLE CARDS ***
Dealt to Hero [Th 8h]
Dealt to 5d46d288 
Dealt to 326ed8a3 
Dealt to d6d937c9 
Dealt to c4607254 
Dealt to 4e885360 
326ed8a3: raises 160 to 320
d6d937c9: folds
c4607254: folds
4e885360: folds
Hero: folds
5d46d288: folds
Uncalled bet (160) returned to 326ed8a3
*** SHOWDOWN ***
326ed8a3 collected 550 from pot
*** SUMMARY ***
Total pot 550
Seat 1: Hero (small blind) folded before Flop
Seat 3: 5d46d288 (big blind) folded before Flop
Seat 4: 326ed8a3 collected (550)
Seat 5: d6d937c9 folded before Flop
Seat 7: c4607254 folded before Flop
Seat 8: 4e885360 (button) folded before Flop


Poker Hand #TM247773627: Tournament #5259595, Daily Special $250 Hold'em No Limit - Level3 (80/160) - 2020/06/02 19:29:36
Table '6' 8-max Seat #1 is the button
Seat 1: Hero (4,393 in chips)
Seat 3: 5d46d288 (16,308 in chips)
Seat 4: 326ed8a3 (11,554 in chips)
Seat 5: d6d937c9 (4,124 in chips)
Seat 7: c4607254 (9,499 in chips)
Seat 8: 4e885360 (20,272 in chips)
326ed8a3: posts the ante 25
4e885360: posts the ante 25
5d46d288: posts the ante 25
d6d937c9: posts the ante 25
c4607254: posts the ante 25
Hero: posts the ante 25
5d46d288: posts small blind 80
326ed8a3: posts big blind 160
*** HOLE CARDS ***
Dealt to Hero [5s 3h]
Dealt to 5d46d288 
Dealt to 326ed8a3 
Dealt to d6d937c9 
Dealt to c4607254 
Dealt to 4e885360 
d6d937c9: folds
c4607254: folds
4e885360: folds
Hero: folds
5d46d288: raises 240 to 400
326ed8a3: folds
Uncalled bet (240) returned to 5d46d288
*** SHOWDOWN ***
5d46d288 collected 470 from pot
*** SUMMARY ***
Total pot 470
Seat 1: Hero (button) folded before Flop
Seat 3: 5d46d288 (small blind) collected (470)
Seat 4: 326ed8a3 (big blind) folded before Flop
Seat 5: d6d937c9 folded before Flop
Seat 7: c4607254 folded before Flop
Seat 8: 4e885360 folded before Flop


Poker Hand #TM247773714: Tournament #5259595, Daily Special $250 Hold'em No Limit - Level3 (80/160) - 2020/06/02 19:30:16
Table '6' 8-max Seat #3 is the button
Seat 1: Hero (4,368 in chips)
Seat 3: 5d46d288 (16,593 in chips)
Seat 4: 326ed8a3 (11,369 in chips)
Seat 5: d6d937c9 (4,099 in chips)
Seat 7: c4607254 (9,474 in chips)
Seat 8: 4e885360 (20,247 in chips)
326ed8a3: posts the ante 25
4e885360: posts the ante 25
5d46d288: posts the ante 25
d6d937c9: posts the ante 25
c4607254: posts the ante 25
Hero: posts the ante 25
326ed8a3: posts small blind 80
d6d937c9: posts big blind 160
*** HOLE CARDS ***
Dealt to Hero [7d 6s]
Dealt to 5d46d288 
Dealt to 326ed8a3 
Dealt to d6d937c9 
Dealt to c4607254 
Dealt to 4e885360 
c4607254: folds
4e885360: raises 208 to 368
Hero: folds
5d46d288: folds
326ed8a3: folds
d6d937c9: calls 208
*** FLOP *** [5s Jh 2h]
d6d937c9: checks
4e885360: bets 628
d6d937c9: calls 628
*** TURN *** [5s Jh 2h] [7c]
d6d937c9: bets 1,324
4e885360: raises 17,902 to 19,226 and is all-in
d6d937c9: calls 1,754 and is all-in
Uncalled bet (16,148) returned to 4e885360
4e885360: shows [Qs Qh] (Pair of Queens)
d6d937c9: shows [9h Th] (Jack-High)
*** RIVER *** [5s Jh 2h 7c] [Qd]
*** SHOWDOWN ***
4e885360 collected 8,378 from pot
*** SUMMARY ***
Total pot 8,378
Board [5s Jh 2h 7c Qd]
Seat 1: Hero folded before Flop
Seat 3: 5d46d288 (button) folded before Flop
Seat 4: 326ed8a3 (small blind) folded before Flop
Seat 5: d6d937c9 (big blind) showed [Th 9h] and lost with Queen-High
Seat 7: c4607254 folded before Flop
Seat 8: 4e885360 showed [Qs Qh] and won (8,378) with Three Queens


Poker Hand #TM247774014: Tournament #5259595, Daily Special $250 Hold'em No Limit - Level3 (80/160) - 2020/06/02 19:32:24
Table '6' 8-max Seat #4 is the button
Seat 1: Hero (4,343 in chips)
Seat 2: 841f9992 (10,000 in chips)
Seat 3: 5d46d288 (16,568 in chips)
Seat 4: 326ed8a3 (11,264 in chips)
Seat 7: c4607254 (9,449 in chips)
Seat 8: 4e885360 (24,526 in chips)
326ed8a3: posts the ante 25
841f9992: posts the ante 25
4e885360: posts the ante 25
5d46d288: posts the ante 25
c4607254: posts the ante 25
Hero: posts the ante 25
c4607254: posts small blind 80
4e885360: posts big blind 160
*** HOLE CARDS ***
Dealt to Hero [9h 3s]
Dealt to 841f9992 
Dealt to 5d46d288 
Dealt to 326ed8a3 
Dealt to c4607254 
Dealt to 4e885360 
Hero: folds
841f9992: raises 176 to 336
5d46d288: folds
326ed8a3: folds
c4607254: folds
4e885360: calls 176
*** FLOP *** [6s 8d Kd]
4e885360: checks
841f9992: bets 298
4e885360: calls 298
*** TURN *** [6s 8d Kd] [Ah]
4e885360: checks
841f9992: checks
*** RIVER *** [6s 8d Kd Ah] [Jh]
4e885360: checks
841f9992: checks
4e885360: shows [5c 6c] (Pair of Sixes)
841f9992: shows [Tc Th] (Pair of Tens)
*** SHOWDOWN ***
841f9992 collected 1,498 from pot
*** SUMMARY ***
Total pot 1,498
Board [6s 8d Kd Ah Jh]
Seat 1: Hero folded before Flop
Seat 2: 841f9992 showed [Th Tc] and won (1,498) with Pair of Tens
Seat 3: 5d46d288 folded before Flop
Seat 4: 326ed8a3 (button) folded before Flop
Seat 7: c4607254 (small blind) folded before Flop
Seat 8: 4e885360 (big blind) showed [6c 5c] and lost with Pair of Sixes


Poker Hand #TM247774245: Tournament #5259595, Daily Special $250 Hold'em No Limit - Level3 (80/160) - 2020/06/02 19:34:01
Table '6' 8-max Seat #7 is the button
Seat 1: Hero (4,318 in chips)
Seat 2: 841f9992 (10,839 in chips)
Seat 3: 5d46d288 (16,543 in chips)
Seat 4: 326ed8a3 (11,239 in chips)
Seat 5: ae0045c4 (10,506 in chips)
Seat 7: c4607254 (9,344 in chips)
Seat 8: 4e885360 (23,867 in chips)
326ed8a3: posts the ante 25
841f9992: posts the ante 25
4e885360: posts the ante 25
ae0045c4: posts the ante 25
5d46d288: posts the ante 25
c4607254: posts the ante 25
Hero: posts the ante 25
4e885360: posts small blind 80
Hero: posts big blind 160
*** HOLE CARDS ***
Dealt to Hero [Kc 3d]
Dealt to 841f9992 
Dealt to 5d46d288 
Dealt to 326ed8a3 
Dealt to ae0045c4 
Dealt to c4607254 
Dealt to 4e885360 
841f9992: folds
5d46d288: folds
326ed8a3: raises 160 to 320
ae0045c4: folds
c4607254: calls 320
4e885360: folds
Hero: folds
*** FLOP *** [2h 7c Jh]
326ed8a3: checks
c4607254: bets 348
326ed8a3: folds
Uncalled bet (348) returned to c4607254
*** SHOWDOWN ***
c4607254 collected 1,055 from pot
*** SUMMARY ***
Total pot 1,055
Board [2h 7c Jh]
Seat 1: Hero (big blind) folded before Flop
Seat 2: 841f9992 folded before Flop
Seat 3: 5d46d288 folded before Flop
Seat 4: 326ed8a3 folded on the Flop
Seat 5: ae0045c4 folded before Flop
Seat 7: c4607254 (button) won (1,055)
Seat 8: 4e885360 (small blind) folded before Flop


Poker Hand #TM247774421: Tournament #5259595, Daily Special $250 Hold'em No Limit - Level3 (80/160) - 2020/06/02 19:35:18
Table '6' 8-max Seat #8 is the button
Seat 1: Hero (4,133 in chips)
Seat 2: 841f9992 (10,814 in chips)
Seat 3: 5d46d288 (16,518 in chips)
Seat 4: 326ed8a3 (10,894 in chips)
Seat 5: ae0045c4 (10,481 in chips)
Seat 6: 4c7cfe42 (10,000 in chips)
Seat 7: c4607254 (10,054 in chips)
Seat 8: 4e885360 (23,762 in chips)
326ed8a3: posts the ante 25
841f9992: posts the ante 25
4e885360: posts the ante 25
4c7cfe42: posts the ante 25
ae0045c4: posts the ante 25
5d46d288: posts the ante 25
c4607254: posts the ante 25
Hero: posts the ante 25
Hero: posts small blind 80
841f9992: posts big blind 160
*** HOLE CARDS ***
Dealt to Hero [7d 3c]
Dealt to 841f9992 
Dealt to 5d46d288 
Dealt to 326ed8a3 
Dealt to ae0045c4 
Dealt to 4c7cfe42 
Dealt to c4607254 
Dealt to 4e885360 
5d46d288: folds
326ed8a3: folds
ae0045c4: folds
4c7cfe42: folds
c4607254: raises 160 to 320
4e885360: folds
Hero: folds
841f9992: calls 160
*** FLOP *** [5d 4s 9c]
841f9992: checks
c4607254: bets 304
841f9992: raises 637 to 941
c4607254: calls 637
*** TURN *** [5d 4s 9c] [3h]
841f9992: checks
c4607254: bets 1,401
841f9992: raises 1,617 to 3,018
c4607254: folds
Uncalled bet (1,617) returned to 841f9992
*** SHOWDOWN ***
841f9992 collected 5,604 from pot
*** SUMMARY ***
Total pot 5,604
Board [5d 4s 9c 3h]
Seat 1: Hero (small blind) folded before Flop
Seat 2: 841f9992 (big blind) won (5,604)
Seat 3: 5d46d288 folded before Flop
Seat 4: 326ed8a3 folded before Flop
Seat 5: ae0045c4 folded before Flop
Seat 6: 4c7cfe42 folded before Flop
Seat 7: c4607254 folded on the Turn
Seat 8: 4e885360 (button) folded before Flop


Poker Hand #TM247774746: Tournament #5259595, Daily Special $250 Hold'em No Limit - Level4 (90/180) - 2020/06/02 19:37:42
Table '6' 8-max Seat #1 is the button
Seat 1: Hero (4,028 in chips)
Seat 2: 841f9992 (13,731 in chips)
Seat 3: 5d46d288 (16,493 in chips)
Seat 4: 326ed8a3 (10,869 in chips)
Seat 5: ae0045c4 (10,456 in chips)
Seat 6: 4c7cfe42 (9,975 in chips)
Seat 7: c4607254 (7,367 in chips)
Seat 8: 4e885360 (23,737 in chips)
326ed8a3: posts the ante 25
841f9992: posts the ante 25
4e885360: posts the ante 25
4c7cfe42: posts the ante 25
ae0045c4: posts the ante 25
5d46d288: posts the ante 25
c4607254: posts the ante 25
Hero: posts the ante 25
841f9992: posts small blind 80
5d46d288: posts big blind 160
*** HOLE CARDS ***
Dealt to Hero [Ks Kc]
Dealt to 841f9992 
Dealt to 5d46d288 
Dealt to 326ed8a3 
Dealt to ae0045c4 
Dealt to 4c7cfe42 
Dealt to c4607254 
Dealt to 4e885360 
326ed8a3: raises 160 to 320
ae0045c4: folds
4c7cfe42: folds
c4607254: folds
4e885360: folds
Hero: calls 320
841f9992: folds
5d46d288: calls 160
*** FLOP *** [Kh 2h Qh]
5d46d288: checks
326ed8a3: checks
Hero: bets 409
5d46d288: calls 409
326ed8a3: folds
*** TURN *** [Kh 2h Qh] [6h]
5d46d288: checks
Hero: checks
*** RIVER *** [Kh 2h Qh 6h] [7h]
5d46d288: bets 2,058
Hero: folds
Uncalled bet (2,058) returned to 5d46d288
*** SHOWDOWN ***
5d46d288 collected 2,058 from pot
*** SUMMARY ***
Total pot 2,058
Board [Kh 2h Qh 6h 7h]
Seat 1: Hero (button) folded on the River
Seat 2: 841f9992 (small blind) folded before Flop
Seat 3: 5d46d288 (big blind) won (2,058)
Seat 4: 326ed8a3 folded on the Flop
Seat 5: ae0045c4 folded before Flop
Seat 6: 4c7cfe42 folded before Flop
Seat 7: c4607254 folded before Flop
Seat 8: 4e885360 folded before Flop


Poker Hand #TM247774954: Tournament #5259595, Daily Special $250 Hold'em No Limit - Level4 (90/180) - 2020/06/02 19:39:16
Table '6' 8-max Seat #2 is the button
Seat 1: Hero (3,274 in chips)
Seat 2: 841f9992 (13,626 in chips)
Seat 3: 5d46d288 (17,797 in chips)
Seat 4: 326ed8a3 (10,524 in chips)
Seat 5: ae0045c4 (10,431 in chips)
Seat 6: 4c7cfe42 (9,950 in chips)
Seat 7: c4607254 (7,342 in chips)
Seat 8: 4e885360 (23,712 in chips)
326ed8a3: posts the ante 30
841f9992: posts the ante 30
4e885360: posts the ante 30
4c7cfe42: posts the ante 30
ae0045c4: posts the ante 30
5d46d288: posts the ante 30
c4607254: posts the ante 30
Hero: posts the ante 30
5d46d288: posts small blind 90
326ed8a3: posts big blind 180
*** HOLE CARDS ***
Dealt to Hero [Tc 3h]
Dealt to 841f9992 
Dealt to 5d46d288 
Dealt to 326ed8a3 
Dealt to ae0045c4 
Dealt to 4c7cfe42 
Dealt to c4607254 
Dealt to 4e885360 
ae0045c4: folds
4c7cfe42: folds
c4607254: folds
4e885360: folds
Hero: folds
841f9992: folds
5d46d288: folds
Uncalled bet (90) returned to 326ed8a3
*** SHOWDOWN ***
326ed8a3 collected 420 from pot
*** SUMMARY ***
Total pot 420
Seat 1: Hero folded before Flop
Seat 2: 841f9992 (button) folded before Flop
Seat 3: 5d46d288 (small blind) folded before Flop
Seat 4: 326ed8a3 (big blind) collected (420)
Seat 5: ae0045c4 folded before Flop
Seat 6: 4c7cfe42 folded before Flop
Seat 7: c4607254 folded before Flop
Seat 8: 4e885360 folded before Flop


Poker Hand #TM247775028: Tournament #5259595, Daily Special $250 Hold'em No Limit - Level4 (90/180) - 2020/06/02 19:39:48
Table '6' 8-max Seat #3 is the button
Seat 1: Hero (3,244 in chips)
Seat 2: 841f9992 (13,596 in chips)
Seat 3: 5d46d288 (17,677 in chips)
Seat 4: 326ed8a3 (10,824 in chips)
Seat 5: ae0045c4 (10,401 in chips)
Seat 6: 4c7cfe42 (9,920 in chips)
Seat 7: c4607254 (7,312 in chips)
Seat 8: 4e885360 (23,682 in chips)
326ed8a3: posts the ante 30
841f9992: posts the ante 30
4e885360: posts the ante 30
4c7cfe42: posts the ante 30
ae0045c4: posts the ante 30
5d46d288: posts the ante 30
c4607254: posts the ante 30
Hero: posts the ante 30
326ed8a3: posts small blind 90
ae0045c4: posts big blind 180
*** HOLE CARDS ***
Dealt to Hero [5h 4h]
Dealt to 841f9992 
Dealt to 5d46d288 
Dealt to 326ed8a3 
Dealt to ae0045c4 
Dealt to 4c7cfe42 
Dealt to c4607254 
Dealt to 4e885360 
4c7cfe42: folds
c4607254: folds
4e885360: folds
Hero: folds
841f9992: raises 216 to 396
5d46d288: folds
326ed8a3: folds
ae0045c4: folds
Uncalled bet (216) returned to 841f9992
*** SHOWDOWN ***
841f9992 collected 690 from pot
*** SUMMARY ***
Total pot 690
Seat 1: Hero folded before Flop
Seat 2: 841f9992 collected (690)
Seat 3: 5d46d288 (button) folded before Flop
Seat 4: 326ed8a3 (small blind) folded before Flop
Seat 5: ae0045c4 (big blind) folded before Flop
Seat 6: 4c7cfe42 folded before Flop
Seat 7: c4607254 folded before Flop
Seat 8: 4e885360 folded before Flop


Poker Hand #TM247775131: Tournament #5259595, Daily Special $250 Hold'em No Limit - Level4 (90/180) - 2020/06/02 19:40:36
Table '6' 8-max Seat #5 is the button
Seat 1: Hero (3,214 in chips)
Seat 2: 841f9992 (14,076 in chips)
Seat 3: 5d46d288 (17,647 in chips)
Seat 5: ae0045c4 (10,191 in chips)
Seat 6: 4c7cfe42 (9,890 in chips)
Seat 7: c4607254 (7,282 in chips)
Seat 8: 4e885360 (23,652 in chips)
841f9992: posts the ante 30
4e885360: posts the ante 30
4c7cfe42: posts the ante 30
ae0045c4: posts the ante 30
5d46d288: posts the ante 30
c4607254: posts the ante 30
Hero: posts the ante 30
4c7cfe42: posts small blind 90
c4607254: posts big blind 180
*** HOLE CARDS ***
Dealt to Hero [Td 3c]
Dealt to 841f9992 
Dealt to 5d46d288 
Dealt to ae0045c4 
Dealt to 4c7cfe42 
Dealt to c4607254 
Dealt to 4e885360 
4e885360: folds
Hero: folds
841f9992: folds
5d46d288: folds
ae0045c4: folds
4c7cfe42: folds
Uncalled bet (90) returned to c4607254
*** SHOWDOWN ***
c4607254 collected 390 from pot
*** SUMMARY ***
Total pot 390
Seat 1: Hero folded before Flop
Seat 2: 841f9992 folded before Flop
Seat 3: 5d46d288 folded before Flop
Seat 5: ae0045c4 (button) folded before Flop
Seat 6: 4c7cfe42 (small blind) folded before Flop
Seat 7: c4607254 (big blind) collected (390)
Seat 8: 4e885360 folded before Flop


Poker Hand #TM247775190: Tournament #5259595, Daily Special $250 Hold'em No Limit - Level4 (90/180) - 2020/06/02 19:41:01
Table '6' 8-max Seat #6 is the button
Seat 1: Hero (3,184 in chips)
Seat 2: 841f9992 (14,046 in chips)
Seat 3: 5d46d288 (17,617 in chips)
Seat 5: ae0045c4 (10,161 in chips)
Seat 6: 4c7cfe42 (9,770 in chips)
Seat 7: c4607254 (7,552 in chips)
Seat 8: 4e885360 (23,622 in chips)
841f9992: posts the ante 30
4e885360: posts the ante 30
4c7cfe42: posts the ante 30
ae0045c4: posts the ante 30
5d46d288: posts the ante 30
c4607254: posts the ante 30
Hero: posts the ante 30
c4607254: posts small blind 90
4e885360: posts big blind 180
*** HOLE CARDS ***
Dealt to Hero [4s 2d]
Dealt to 841f9992 
Dealt to 5d46d288 
Dealt to ae0045c4 
Dealt to 4c7cfe42 
Dealt to c4607254 
Dealt to 4e885360 
Hero: folds
841f9992: folds
5d46d288: folds
ae0045c4: folds
4c7cfe42: raises 180 to 360
c4607254: folds
4e885360: calls 180
*** FLOP *** [2c Ts 9c]
4e885360: checks
4c7cfe42: checks
*** TURN *** [2c Ts 9c] [Ks]
4e885360: checks
4c7cfe42: bets 765
4e885360: folds
Uncalled bet (765) returned to 4c7cfe42
*** SHOWDOWN ***
4c7cfe42 collected 1,020 from pot
*** SUMMARY ***
Total pot 1,020
Board [2c Ts 9c Ks]
Seat 1: Hero folded before Flop
Seat 2: 841f9992 folded before Flop
Seat 3: 5d46d288 folded before Flop
Seat 5: ae0045c4 folded before Flop
Seat 6: 4c7cfe42 (button) won (1,020)
Seat 7: c4607254 (small blind) folded before Flop
Seat 8: 4e885360 (big blind) folded on the Turn


Poker Hand #TM247775447: Tournament #5259595, Daily Special $250 Hold'em No Limit - Level4 (90/180) - 2020/06/02 19:43:00
Table '6' 8-max Seat #7 is the button
Seat 1: Hero (3,154 in chips)
Seat 2: 841f9992 (14,016 in chips)
Seat 3: 5d46d288 (17,587 in chips)
Seat 5: ae0045c4 (10,131 in chips)
Seat 6: 4c7cfe42 (10,400 in chips)
Seat 7: c4607254 (7,432 in chips)
Seat 8: 4e885360 (23,232 in chips)
841f9992: posts the ante 30
4e885360: posts the ante 30
4c7cfe42: posts the ante 30
ae0045c4: posts the ante 30
5d46d288: posts the ante 30
c4607254: posts the ante 30
Hero: posts the ante 30
4e885360: posts small blind 90
Hero: posts big blind 180
*** HOLE CARDS ***
Dealt to Hero [8d 4h]
Dealt to 841f9992 
Dealt to 5d46d288 
Dealt to ae0045c4 
Dealt to 4c7cfe42 
Dealt to c4607254 
Dealt to 4e885360 
841f9992: folds
5d46d288: raises 270 to 450
ae0045c4: folds
4c7cfe42: folds
c4607254: folds
4e885360: folds
Hero: folds
Uncalled bet (270) returned to 5d46d288
*** SHOWDOWN ***
5d46d288 collected 660 from pot
*** SUMMARY ***
Total pot 660
Seat 1: Hero (big blind) folded before Flop
Seat 2: 841f9992 folded before Flop
Seat 3: 5d46d288 collected (660)
Seat 5: ae0045c4 folded before Flop
Seat 6: 4c7cfe42 folded before Flop
Seat 7: c4607254 (button) folded before Flop
Seat 8: 4e885360 (small blind) folded before Flop


Poker Hand #TM247775515: Tournament #5259595, Daily Special $250 Hold'em No Limit - Level4 (90/180) - 2020/06/02 19:43:31
Table '6' 8-max Seat #8 is the button
Seat 1: Hero (2,944 in chips)
Seat 2: 841f9992 (13,986 in chips)
Seat 3: 5d46d288 (18,037 in chips)
Seat 5: ae0045c4 (10,101 in chips)
Seat 6: 4c7cfe42 (10,370 in chips)
Seat 7: c4607254 (7,402 in chips)
Seat 8: 4e885360 (23,112 in chips)
841f9992: posts the ante 30
4e885360: posts the ante 30
4c7cfe42: posts the ante 30
ae0045c4: posts the ante 30
5d46d288: posts the ante 30
c4607254: posts the ante 30
Hero: posts the ante 30
Hero: posts small blind 90
841f9992: posts big blind 180
*** HOLE CARDS ***
Dealt to Hero [8c 4s]
Dealt to 841f9992 
Dealt to 5d46d288 
Dealt to ae0045c4 
Dealt to 4c7cfe42 
Dealt to c4607254 
Dealt to 4e885360 
5d46d288: folds
ae0045c4: folds
4c7cfe42: raises 180 to 360
c4607254: folds
4e885360: folds
Hero: folds
841f9992: calls 180
*** FLOP *** [Td Jd Qh]
841f9992: checks
4c7cfe42: checks
*** TURN *** [Td Jd Qh] [Qc]
841f9992: checks
4c7cfe42: bets 255
841f9992: folds
Uncalled bet (255) returned to 4c7cfe42
*** SHOWDOWN ***
4c7cfe42 collected 1,020 from pot
*** SUMMARY ***
Total pot 1,020
Board [Td Jd Qh Qc]
Seat 1: Hero (small blind) folded before Flop
Seat 2: 841f9992 (big blind) folded on the Turn
Seat 3: 5d46d288 folded before Flop
Seat 5: ae0045c4 folded before Flop
Seat 6: 4c7cfe42 won (1,020)
Seat 7: c4607254 folded before Flop
Seat 8: 4e885360 (button) folded before Flop


Poker Hand #TM247775657: Tournament #5259595, Daily Special $250 Hold'em No Limit - Level4 (90/180) - 2020/06/02 19:44:33
Table '6' 8-max Seat #1 is the button
Seat 1: Hero (2,824 in chips)
Seat 2: 841f9992 (13,596 in chips)
Seat 3: 5d46d288 (18,007 in chips)
Seat 5: ae0045c4 (10,071 in chips)
Seat 6: 4c7cfe42 (11,000 in chips)
Seat 7: c4607254 (7,372 in chips)
Seat 8: 4e885360 (23,082 in chips)
841f9992: posts the ante 30
4e885360: posts the ante 30
4c7cfe42: posts the ante 30
ae0045c4: posts the ante 30
5d46d288: posts the ante 30
c4607254: posts the ante 30
Hero: posts the ante 30
841f9992: posts small blind 90
5d46d288: posts big blind 180
*** HOLE CARDS ***
Dealt to Hero [8c 4h]
Dealt to 841f9992 
Dealt to 5d46d288 
Dealt to ae0045c4 
Dealt to 4c7cfe42 
Dealt to c4607254 
Dealt to 4e885360 
ae0045c4: folds
4c7cfe42: folds
c4607254: folds
4e885360: folds
Hero: folds
841f9992: raises 450 to 630
5d46d288: folds
Uncalled bet (450) returned to 841f9992
*** SHOWDOWN ***
841f9992 collected 570 from pot
*** SUMMARY ***
Total pot 570
Seat 1: Hero (button) folded before Flop
Seat 2: 841f9992 (small blind) collected (570)
Seat 3: 5d46d288 (big blind) folded before Flop
Seat 5: ae0045c4 folded before Flop
Seat 6: 4c7cfe42 folded before Flop
Seat 7: c4607254 folded before Flop
Seat 8: 4e885360 folded before Flop


Poker Hand #TM247775754: Tournament #5259595, Daily Special $250 Hold'em No Limit - Level4 (90/180) - 2020/06/02 19:45:18
Table '6' 8-max Seat #2 is the button
Seat 1: Hero (2,794 in chips)
Seat 2: 841f9992 (13,956 in chips)
Seat 3: 5d46d288 (17,797 in chips)
Seat 4: c1468789 (10,000 in chips)
Seat 5: ae0045c4 (10,041 in chips)
Seat 6: 4c7cfe42 (10,970 in chips)
Seat 7: c4607254 (7,342 in chips)
Seat 8: 4e885360 (23,052 in chips)
841f9992: posts the ante 30
4e885360: posts the ante 30
4c7cfe42: posts the ante 30
ae0045c4: posts the ante 30
5d46d288: posts the ante 30
c4607254: posts the ante 30
c1468789: posts the ante 30
Hero: posts the ante 30
5d46d288: posts small blind 90
c1468789: posts big blind 180
*** HOLE CARDS ***
Dealt to Hero [Qh 2c]
Dealt to 841f9992 
Dealt to 5d46d288 
Dealt to c1468789 
Dealt to ae0045c4 
Dealt to 4c7cfe42 
Dealt to c4607254 
Dealt to 4e885360 
ae0045c4: folds
4c7cfe42: raises 180 to 360
c4607254: folds
4e885360: folds
Hero: folds
841f9992: folds
5d46d288: folds
c1468789: folds
Uncalled bet (180) returned to 4c7cfe42
*** SHOWDOWN ***
4c7cfe42 collected 690 from pot
*** SUMMARY ***
Total pot 690
Seat 1: Hero folded before Flop
Seat 2: 841f9992 (button) folded before Flop
Seat 3: 5d46d288 (small blind) folded before Flop
Seat 4: c1468789 (big blind) folded before Flop
Seat 5: ae0045c4 folded before Flop
Seat 6: 4c7cfe42 collected (690)
Seat 7: c4607254 folded before Flop
Seat 8: 4e885360 folded before Flop


Poker Hand #TM247775837: Tournament #5259595, Daily Special $250 Hold'em No Limit - Level4 (90/180) - 2020/06/02 19:46:00
Table '6' 8-max Seat #3 is the button
Seat 1: Hero (2,764 in chips)
Seat 2: 841f9992 (13,926 in chips)
Seat 3: 5d46d288 (17,677 in chips)
Seat 4: c1468789 (9,790 in chips)
Seat 5: ae0045c4 (10,011 in chips)
Seat 6: 4c7cfe42 (11,450 in chips)
Seat 7: c4607254 (7,312 in chips)
Seat 8: 4e885360 (23,022 in chips)
841f9992: posts the ante 30
4e885360: posts the ante 30
4c7cfe42: posts the ante 30
ae0045c4: posts the ante 30
5d46d288: posts the ante 30
c4607254: posts the ante 30
c1468789: posts the ante 30
Hero: posts the ante 30
c1468789: posts small blind 90
ae0045c4: posts big blind 180
*** HOLE CARDS ***
Dealt to Hero [9d 2s]
Dealt to 841f9992 
Dealt to 5d46d288 
Dealt to c1468789 
Dealt to ae0045c4 
Dealt to 4c7cfe42 
Dealt to c4607254 
Dealt to 4e885360 
4c7cfe42: raises 216 to 396
c4607254: folds
4e885360: folds
Hero: folds
841f9992: folds
5d46d288: calls 396
c1468789: folds
ae0045c4: calls 216
*** FLOP *** [Qd 7s 5s]
ae0045c4: checks
4c7cfe42: bets 540
5d46d288: calls 540
ae0045c4: folds
*** TURN *** [Qd 7s 5s] [6d]
4c7cfe42: checks
5d46d288: checks
*** RIVER *** [Qd 7s 5s 6d] [4s]
4c7cfe42: checks
5d46d288: bets 2,778
4c7cfe42: folds
Uncalled bet (2,778) returned to 5d46d288
*** SHOWDOWN ***
5d46d288 collected 2,598 from pot
*** SUMMARY ***
Total pot 2,598
Board [Qd 7s 5s 6d 4s]
Seat 1: Hero folded before Flop
Seat 2: 841f9992 folded before Flop
Seat 3: 5d46d288 (button) won (2,598)
Seat 4: c1468789 (small blind) folded before Flop
Seat 5: ae0045c4 (big blind) folded on the Flop
Seat 6: 4c7cfe42 folded on the River
Seat 7: c4607254 folded before Flop
Seat 8: 4e885360 folded before Flop


Poker Hand #TM247776160: Tournament #5259595, Daily Special $250 Hold'em No Limit - Level4 (90/180) - 2020/06/02 19:48:34
Table '6' 8-max Seat #4 is the button
Seat 1: Hero (2,734 in chips)
Seat 2: 841f9992 (13,896 in chips)
Seat 3: 5d46d288 (19,309 in chips)
Seat 4: c1468789 (9,670 in chips)
Seat 5: ae0045c4 (9,585 in chips)
Seat 6: 4c7cfe42 (10,484 in chips)
Seat 7: c4607254 (7,282 in chips)
Seat 8: 4e885360 (22,992 in chips)
841f9992: posts the ante 30
4e885360: posts the ante 30
4c7cfe42: posts the ante 30
ae0045c4: posts the ante 30
5d46d288: posts the ante 30
c4607254: posts the ante 30
c1468789: posts the ante 30
Hero: posts the ante 30
ae0045c4: posts small blind 90
4c7cfe42: posts big blind 180
*** HOLE CARDS ***
Dealt to Hero [As 3s]
Dealt to 841f9992 
Dealt to 5d46d288 
Dealt to c1468789 
Dealt to ae0045c4 
Dealt to 4c7cfe42 
Dealt to c4607254 
Dealt to 4e885360 
c4607254: folds
4e885360: folds
Hero: raises 2,524 to 2,704 and is all-in
841f9992: folds
5d46d288: raises 3,064 to 5,768
c1468789: folds
ae0045c4: folds
4c7cfe42: folds
Uncalled bet (3,064) returned to 5d46d288
5d46d288: shows [Js Jd]
Hero: shows [As 3s]
*** FLOP *** [5c 4c Qh]
*** TURN *** [5c 4c Qh] [8c]
*** RIVER *** [5c 4c Qh 8c] [Ad]
*** SHOWDOWN ***
Hero collected 5,918 from pot
*** SUMMARY ***
Total pot 5,918
Board [5c 4c Qh 8c Ad]
Seat 1: Hero showed [As 3s] and won (5,918) with Pair of Aces
Seat 2: 841f9992 folded before Flop
Seat 3: 5d46d288 showed [Js Jd] and lost with Pair of Jacks
Seat 4: c1468789 (button) folded before Flop
Seat 5: ae0045c4 (small blind) folded before Flop
Seat 6: 4c7cfe42 (big blind) folded before Flop
Seat 7: c4607254 folded before Flop
Seat 8: 4e885360 folded before Flop


Poker Hand #TM247776302: Tournament #5259595, Daily Special $250 Hold'em No Limit - Level4 (90/180) - 2020/06/02 19:49:46
Table '6' 8-max Seat #5 is the button
Seat 1: Hero (5,918 in chips)
Seat 2: 841f9992 (13,866 in chips)
Seat 3: 5d46d288 (16,575 in chips)
Seat 4: c1468789 (9,640 in chips)
Seat 5: ae0045c4 (9,465 in chips)
Seat 6: 4c7cfe42 (10,274 in chips)
Seat 7: c4607254 (7,252 in chips)
Seat 8: 4e885360 (22,962 in chips)
841f9992: posts the ante 30
4e885360: posts the ante 30
4c7cfe42: posts the ante 30
ae0045c4: posts the ante 30
5d46d288: posts the ante 30
c4607254: posts the ante 30
c1468789: posts the ante 30
Hero: posts the ante 30
4c7cfe42: posts small blind 90
c4607254: posts big blind 180
*** HOLE CARDS ***
Dealt to Hero [9s 7s]
Dealt to 841f9992 
Dealt to 5d46d288 
Dealt to c1468789 
Dealt to ae0045c4 
Dealt to 4c7cfe42 
Dealt to c4607254 
Dealt to 4e885360 
4e885360: folds
Hero: folds
841f9992: folds
5d46d288: raises 270 to 450
c1468789: folds
ae0045c4: folds
4c7cfe42: folds
c4607254: calls 270
*** FLOP *** [5d 3h 8c]
c4607254: checks
5d46d288: checks
*** TURN *** [5d 3h 8c] [7h]
c4607254: bets 615
5d46d288: folds
Uncalled bet (615) returned to c4607254
*** SHOWDOWN ***
c4607254 collected 1,230 from pot
*** SUMMARY ***
Total pot 1,230
Board [5d 3h 8c 7h]
Seat 1: Hero folded before Flop
Seat 2: 841f9992 folded before Flop
Seat 3: 5d46d288 folded on the Turn
Seat 4: c1468789 folded before Flop
Seat 5: ae0045c4 (button) folded before Flop
Seat 6: 4c7cfe42 (small blind) folded before Flop
Seat 7: c4607254 (big blind) won (1,230)
Seat 8: 4e885360 folded before Flop


Poker Hand #TM247776533: Tournament #5259595, Daily Special $250 Hold'em No Limit - Level5 (100/200) - 2020/06/02 19:51:36
Table '6' 8-max Seat #6 is the button
Seat 1: Hero (5,888 in chips)
Seat 2: 841f9992 (13,836 in chips)
Seat 3: 5d46d288 (16,095 in chips)
Seat 4: c1468789 (9,610 in chips)
Seat 5: ae0045c4 (9,435 in chips)
Seat 6: 4c7cfe42 (10,154 in chips)
Seat 7: c4607254 (8,002 in chips)
Seat 8: 4e885360 (22,932 in chips)
841f9992: posts the ante 30
4e885360: posts the ante 30
4c7cfe42: posts the ante 30
ae0045c4: posts the ante 30
5d46d288: posts the ante 30
c4607254: posts the ante 30
c1468789: posts the ante 30
Hero: posts the ante 30
c4607254: posts small blind 90
4e885360: posts big blind 180
*** HOLE CARDS ***
Dealt to Hero [5h 5c]
Dealt to 841f9992 
Dealt to 5d46d288 
Dealt to c1468789 
Dealt to ae0045c4 
Dealt to 4c7cfe42 
Dealt to c4607254 
Dealt to 4e885360 
Hero: raises 270 to 450
841f9992: folds
5d46d288: folds
c1468789: folds
ae0045c4: folds
4c7cfe42: folds
c4607254: folds
4e885360: calls 270
*** FLOP *** [Ad 4d Jc]
4e885360: checks
Hero: bets 360
4e885360: calls 360
*** TURN *** [Ad 4d Jc] [2h]
4e885360: checks
Hero: bets 1,155
4e885360: calls 1,155
*** RIVER *** [Ad 4d Jc 2h] [3s]
4e885360: checks
Hero: bets 3,893 and is all-in
4e885360: calls 3,893
Hero: shows [5h 5c] (Fives-High Straight)
4e885360: shows [7d Ah] (Pair of Aces)
*** SHOWDOWN ***
Hero collected 12,046 from pot
*** SUMMARY ***
Total pot 12,046
Board [Ad 4d Jc 2h 3s]
Seat 1: Hero showed [5h 5c] and won (12,046) with Fives-High Straight
Seat 2: 841f9992 folded before Flop
Seat 3: 5d46d288 folded before Flop
Seat 4: c1468789 folded before Flop
Seat 5: ae0045c4 folded before Flop
Seat 6: 4c7cfe42 (button) folded before Flop
Seat 7: c4607254 (small blind) folded before Flop
Seat 8: 4e885360 (big blind) showed [Ah 7d] and lost with Pair of Aces


Poker Hand #TM247776748: Tournament #5259595, Daily Special $250 Hold'em No Limit - Level5 (100/200) - 2020/06/02 19:53:33
Table '6' 8-max Seat #7 is the button
Seat 1: Hero (12,046 in chips)
Seat 2: 841f9992 (13,806 in chips)
Seat 3: 5d46d288 (16,065 in chips)
Seat 4: c1468789 (9,580 in chips)
Seat 5: ae0045c4 (9,405 in chips)
Seat 6: 4c7cfe42 (10,124 in chips)
Seat 7: c4607254 (7,882 in chips)
Seat 8: 4e885360 (17,044 in chips)
841f9992: posts the ante 36
4e885360: posts the ante 36
4c7cfe42: posts the ante 36
ae0045c4: posts the ante 36
5d46d288: posts the ante 36
c4607254: posts the ante 36
c1468789: posts the ante 36
Hero: posts the ante 36
4e885360: posts small blind 100
Hero: posts big blind 200
*** HOLE CARDS ***
Dealt to Hero [Ad 5c]
Dealt to 841f9992 
Dealt to 5d46d288 
Dealt to c1468789 
Dealt to ae0045c4 
Dealt to 4c7cfe42 
Dealt to c4607254 
Dealt to 4e885360 
841f9992: folds
5d46d288: raises 300 to 500
c1468789: calls 500
ae0045c4: folds
4c7cfe42: folds
c4607254: folds
4e885360: folds
Hero: folds
*** FLOP *** [6d 3h 9c]
5d46d288: checks
c1468789: checks
*** TURN *** [6d 3h 9c] [7d]
5d46d288: bets 524
c1468789: raises 1,440 to 1,964
5d46d288: calls 1,440
*** RIVER *** [6d 3h 9c 7d] [4s]
5d46d288: checks
c1468789: bets 4,341
5d46d288: calls 4,341
c1468789: shows [7h 7c] (Three Sevens)
5d46d288: shows [As Kd] (Ace-High)
*** SHOWDOWN ***
c1468789 collected 14,198 from pot
*** SUMMARY ***
Total pot 14,198
Board [6d 3h 9c 7d 4s]
Seat 1: Hero (big blind) folded before Flop
Seat 2: 841f9992 folded before Flop
Seat 3: 5d46d288 showed [As Kd] and lost with Ace-High
Seat 4: c1468789 showed [7h 7c] and won (14,198) with Three Sevens
Seat 5: ae0045c4 folded before Flop
Seat 6: 4c7cfe42 folded before Flop
Seat 7: c4607254 (button) folded before Flop
Seat 8: 4e885360 (small blind) folded before Flop


Poker Hand #TM247777004: Tournament #5259595, Daily Special $250 Hold'em No Limit - Level5 (100/200) - 2020/06/02 20:02:46
Table '6' 8-max Seat #8 is the button
Seat 1: Hero (11,810 in chips)
Seat 2: 841f9992 (13,770 in chips)
Seat 3: 5d46d288 (9,224 in chips)
Seat 4: c1468789 (16,937 in chips)
Seat 5: ae0045c4 (9,369 in chips)
Seat 6: 4c7cfe42 (10,088 in chips)
Seat 7: c4607254 (7,846 in chips)
Seat 8: 4e885360 (16,908 in chips)
841f9992: posts the ante 36
4e885360: posts the ante 36
4c7cfe42: posts the ante 36
ae0045c4: posts the ante 36
5d46d288: posts the ante 36
c4607254: posts the ante 36
c1468789: posts the ante 36
Hero: posts the ante 36
Hero: posts small blind 100
841f9992: posts big blind 200
*** HOLE CARDS ***
Dealt to Hero [Qc 4d]
Dealt to 841f9992 
Dealt to 5d46d288 
Dealt to c1468789 
Dealt to ae0045c4 
Dealt to 4c7cfe42 
Dealt to c4607254 
Dealt to 4e885360 
5d46d288: folds
c1468789: folds
ae0045c4: folds
4c7cfe42: folds
c4607254: raises 200 to 400
4e885360: raises 902 to 1,302
Hero: folds
841f9992: folds
c4607254: folds
Uncalled bet (902) returned to 4e885360
*** SHOWDOWN ***
4e885360 collected 1,388 from pot
*** SUMMARY ***
Total pot 1,388
Seat 1: Hero (small blind) folded before Flop
Seat 2: 841f9992 (big blind) folded before Flop
Seat 3: 5d46d288 folded before Flop
Seat 4: c1468789 folded before Flop
Seat 5: ae0045c4 folded before Flop
Seat 6: 4c7cfe42 folded before Flop
Seat 7: c4607254 folded before Flop
Seat 8: 4e885360 (button) collected (1,388)


Poker Hand #TM247777104: Tournament #5259595, Daily Special $250 Hold'em No Limit - Level5 (100/200) - 2020/06/02 20:04:00
Table '6' 8-max Seat #1 is the button
Seat 1: Hero (11,674 in chips)
Seat 2: 841f9992 (13,534 in chips)
Seat 3: 5d46d288 (9,188 in chips)
Seat 4: c1468789 (16,901 in chips)
Seat 5: ae0045c4 (9,333 in chips)
Seat 6: 4c7cfe42 (10,052 in chips)
Seat 7: c4607254 (7,410 in chips)
Seat 8: 4e885360 (17,860 in chips)
841f9992: posts the ante 36
4e885360: posts the ante 36
4c7cfe42: posts the ante 36
ae0045c4: posts the ante 36
5d46d288: posts the ante 36
c4607254: posts the ante 36
c1468789: posts the ante 36
Hero: posts the ante 36
841f9992: posts small blind 100
5d46d288: posts big blind 200
*** HOLE CARDS ***
Dealt to Hero [Kd 7h]
Dealt to 841f9992 
Dealt to 5d46d288 
Dealt to c1468789 
Dealt to ae0045c4 
Dealt to 4c7cfe42 
Dealt to c4607254 
Dealt to 4e885360 
c1468789: folds
ae0045c4: folds
4c7cfe42: folds
c4607254: folds
4e885360: raises 259 to 459
Hero: folds
841f9992: folds
5d46d288: folds
Uncalled bet (259) returned to 4e885360
*** SHOWDOWN ***
4e885360 collected 788 from pot
*** SUMMARY ***
Total pot 788
Seat 1: Hero (button) folded before Flop
Seat 2: 841f9992 (small blind) folded before Flop
Seat 3: 5d46d288 (big blind) folded before Flop
Seat 4: c1468789 folded before Flop
Seat 5: ae0045c4 folded before Flop
Seat 6: 4c7cfe42 folded before Flop
Seat 7: c4607254 folded before Flop
Seat 8: 4e885360 collected (788)


Poker Hand #TM247777214: Tournament #5259595, Daily Special $250 Hold'em No Limit - Level5 (100/200) - 2020/06/02 20:05:03
Table '6' 8-max Seat #2 is the button
Seat 1: Hero (11,638 in chips)
Seat 2: 841f9992 (13,398 in chips)
Seat 3: 5d46d288 (8,952 in chips)
Seat 4: c1468789 (16,865 in chips)
Seat 5: ae0045c4 (9,297 in chips)
Seat 6: 4c7cfe42 (10,016 in chips)
Seat 7: c4607254 (7,374 in chips)
Seat 8: 4e885360 (18,412 in chips)
841f9992: posts the ante 36
4e885360: posts the ante 36
4c7cfe42: posts the ante 36
ae0045c4: posts the ante 36
5d46d288: posts the ante 36
c4607254: posts the ante 36
c1468789: posts the ante 36
Hero: posts the ante 36
5d46d288: posts small blind 100
c1468789: posts big blind 200
*** HOLE CARDS ***
Dealt to Hero [Th 2d]
Dealt to 841f9992 
Dealt to 5d46d288 
Dealt to c1468789 
Dealt to ae0045c4 
Dealt to 4c7cfe42 
Dealt to c4607254 
Dealt to 4e885360 
ae0045c4: folds
4c7cfe42: raises 200 to 400
c4607254: folds
4e885360: folds
Hero: folds
841f9992: folds
5d46d288: folds
c1468789: folds
Uncalled bet (200) returned to 4c7cfe42
*** SHOWDOWN ***
4c7cfe42 collected 788 from pot
*** SUMMARY ***
Total pot 788
Seat 1: Hero folded before Flop
Seat 2: 841f9992 (button) folded before Flop
Seat 3: 5d46d288 (small blind) folded before Flop
Seat 4: c1468789 (big blind) folded before Flop
Seat 5: ae0045c4 folded before Flop
Seat 6: 4c7cfe42 collected (788)
Seat 7: c4607254 folded before Flop
Seat 8: 4e885360 folded before Flop


Poker Hand #TM247777304: Tournament #5259595, Daily Special $250 Hold'em No Limit - Level5 (100/200) - 2020/06/02 20:05:53
Table '6' 8-max Seat #3 is the button
Seat 1: Hero (11,602 in chips)
Seat 2: 841f9992 (13,362 in chips)
Seat 3: 5d46d288 (8,816 in chips)
Seat 4: c1468789 (16,629 in chips)
Seat 5: ae0045c4 (9,261 in chips)
Seat 6: 4c7cfe42 (10,568 in chips)
Seat 7: c4607254 (7,338 in chips)
Seat 8: 4e885360 (18,376 in chips)
841f9992: posts the ante 36
4e885360: posts the ante 36
4c7cfe42: posts the ante 36
ae0045c4: posts the ante 36
5d46d288: posts the ante 36
c4607254: posts the ante 36
c1468789: posts the ante 36
Hero: posts the ante 36
c1468789: posts small blind 100
ae0045c4: posts big blind 200
*** HOLE CARDS ***
Dealt to Hero [Jd 6d]
Dealt to 841f9992 
Dealt to 5d46d288 
Dealt to c1468789 
Dealt to ae0045c4 
Dealt to 4c7cfe42 
Dealt to c4607254 
Dealt to 4e885360 
4c7cfe42: folds
c4607254: folds
4e885360: folds
Hero: folds
841f9992: folds
5d46d288: folds
c1468789: calls 100
ae0045c4: checks
*** FLOP *** [2s Kd 5s]
c1468789: bets 200
ae0045c4: folds
Uncalled bet (200) returned to c1468789
*** SHOWDOWN ***
c1468789 collected 688 from pot
*** SUMMARY ***
Total pot 688
Board [2s Kd 5s]
Seat 1: Hero folded before Flop
Seat 2: 841f9992 folded before Flop
Seat 3: 5d46d288 (button) folded before Flop
Seat 4: c1468789 (small blind) won (688)
Seat 5: ae0045c4 (big blind) folded on the Flop
Seat 6: 4c7cfe42 folded before Flop
Seat 7: c4607254 folded before Flop
Seat 8: 4e885360 folded before Flop


Poker Hand #TM247777428: Tournament #5259595, Daily Special $250 Hold'em No Limit - Level5 (100/200) - 2020/06/02 20:06:55
Table '6' 8-max Seat #4 is the button
Seat 1: Hero (11,566 in chips)
Seat 2: 841f9992 (13,326 in chips)
Seat 3: 5d46d288 (8,780 in chips)
Seat 4: c1468789 (17,081 in chips)
Seat 5: ae0045c4 (9,025 in chips)
Seat 6: 4c7cfe42 (10,532 in chips)
Seat 7: c4607254 (7,302 in chips)
Seat 8: 4e885360 (18,340 in chips)
841f9992: posts the ante 36
4e885360: posts the ante 36
4c7cfe42: posts the ante 36
ae0045c4: posts the ante 36
5d46d288: posts the ante 36
c4607254: posts the ante 36
c1468789: posts the ante 36
Hero: posts the ante 36
ae0045c4: posts small blind 100
4c7cfe42: posts big blind 200
*** HOLE CARDS ***
Dealt to Hero [8c 3s]
Dealt to 841f9992 
Dealt to 5d46d288 
Dealt to c1468789 
Dealt to ae0045c4 
Dealt to 4c7cfe42 
Dealt to c4607254 
Dealt to 4e885360 
c4607254: folds
4e885360: raises 259 to 459
Hero: folds
841f9992: folds
5d46d288: folds
c1468789: folds
ae0045c4: folds
4c7cfe42: calls 259
*** FLOP *** [Ah 9c 8d]
4c7cfe42: checks
4e885360: bets 431
4c7cfe42: calls 431
*** TURN *** [Ah 9c 8d] [5c]
4c7cfe42: checks
4e885360: checks
*** RIVER *** [Ah 9c 8d 5c] [Jd]
4c7cfe42: checks
4e885360: bets 1,084
4c7cfe42: folds
Uncalled bet (1,084) returned to 4e885360
*** SHOWDOWN ***
4e885360 collected 2,168 from pot
*** SUMMARY ***
Total pot 2,168
Board [Ah 9c 8d 5c Jd]
Seat 1: Hero folded before Flop
Seat 2: 841f9992 folded before Flop
Seat 3: 5d46d288 folded before Flop
Seat 4: c1468789 (button) folded before Flop
Seat 5: ae0045c4 (small blind) folded before Flop
Seat 6: 4c7cfe42 (big blind) folded on the River
Seat 7: c4607254 folded before Flop
Seat 8: 4e885360 won (2,168)


Poker Hand #TM247777668: Tournament #5259595, Daily Special $250 Hold'em No Limit - Level5 (100/200) - 2020/06/02 20:09:01
Table '6' 8-max Seat #5 is the button
Seat 1: Hero (11,530 in chips)
Seat 2: 841f9992 (13,290 in chips)
Seat 3: 5d46d288 (8,744 in chips)
Seat 4: c1468789 (17,045 in chips)
Seat 5: ae0045c4 (8,889 in chips)
Seat 6: 4c7cfe42 (9,606 in chips)
Seat 7: c4607254 (7,266 in chips)
Seat 8: 4e885360 (19,582 in chips)
841f9992: posts the ante 36
4e885360: posts the ante 36
4c7cfe42: posts the ante 36
ae0045c4: posts the ante 36
5d46d288: posts the ante 36
c4607254: posts the ante 36
c1468789: posts the ante 36
Hero: posts the ante 36
4c7cfe42: posts small blind 100
c4607254: posts big blind 200
*** HOLE CARDS ***
Dealt to Hero [Qd Jc]
Dealt to 841f9992 
Dealt to 5d46d288 
Dealt to c1468789 
Dealt to ae0045c4 
Dealt to 4c7cfe42 
Dealt to c4607254 
Dealt to 4e885360 
4e885360: folds
Hero: folds
841f9992: folds
5d46d288: folds
c1468789: folds
ae0045c4: raises 259 to 459
4c7cfe42: folds
c4607254: raises 6,771 to 7,230 and is all-in
ae0045c4: folds
Uncalled bet (6,771) returned to c4607254
*** SHOWDOWN ***
c4607254 collected 1,306 from pot
*** SUMMARY ***
Total pot 1,306
Seat 1: Hero folded before Flop
Seat 2: 841f9992 folded before Flop
Seat 3: 5d46d288 folded before Flop
Seat 4: c1468789 folded before Flop
Seat 5: ae0045c4 (button) folded before Flop
Seat 6: 4c7cfe42 (small blind) folded before Flop
Seat 7: c4607254 (big blind) collected (1,306)
Seat 8: 4e885360 folded before Flop


Poker Hand #TM247777788: Tournament #5259595, Daily Special $250 Hold'em No Limit - Level5 (100/200) - 2020/06/02 20:10:02
Table '6' 8-max Seat #6 is the button
Seat 1: Hero (11,494 in chips)
Seat 2: 841f9992 (13,254 in chips)
Seat 3: 5d46d288 (8,708 in chips)
Seat 4: c1468789 (17,009 in chips)
Seat 5: ae0045c4 (8,394 in chips)
Seat 6: 4c7cfe42 (9,470 in chips)
Seat 7: c4607254 (8,077 in chips)
Seat 8: 4e885360 (19,546 in chips)
841f9992: posts the ante 36
4e885360: posts the ante 36
4c7cfe42: posts the ante 36
ae0045c4: posts the ante 36
5d46d288: posts the ante 36
c4607254: posts the ante 36
c1468789: posts the ante 36
Hero: posts the ante 36
c4607254: posts small blind 100
4e885360: posts big blind 200
*** HOLE CARDS ***
Dealt to Hero [9s 2c]
Dealt to 841f9992 
Dealt to 5d46d288 
Dealt to c1468789 
Dealt to ae0045c4 
Dealt to 4c7cfe42 
Dealt to c4607254 
Dealt to 4e885360 
Hero: folds
841f9992: folds
5d46d288: folds
c1468789: folds
ae0045c4: folds
4c7cfe42: raises 200 to 400
c4607254: calls 300
4e885360: calls 200
*** FLOP *** [3s Ad Tc]
c4607254: checks
4e885360: checks
4c7cfe42: checks
*** TURN *** [3s Ad Tc] [2s]
c4607254: checks
4e885360: checks
4c7cfe42: bets 595
c4607254: folds
4e885360: calls 595
*** RIVER *** [3s Ad Tc 2s] [9d]
4e885360: bets 884
4c7cfe42: calls 884
4e885360: shows [Ah 4h] (Pair of Aces)
4c7cfe42: shows [As 8c] (Pair of Aces)
*** SHOWDOWN ***
4c7cfe42 collected 4,446 from pot
*** SUMMARY ***
Total pot 4,446
Board [3s Ad Tc 2s 9d]
Seat 1: Hero folded before Flop
Seat 2: 841f9992 folded before Flop
Seat 3: 5d46d288 folded before Flop
Seat 4: c1468789 folded before Flop
Seat 5: ae0045c4 folded before Flop
Seat 6: 4c7cfe42 (button) showed [As 8c] and won (4,446) with Pair of Aces
Seat 7: c4607254 (small blind) folded on the Turn
Seat 8: 4e885360 (big blind) showed [Ah 4h] and lost with Pair of Aces


Poker Hand #TM247777995: Tournament #5259595, Daily Special $250 Hold'em No Limit - Level6 (125/250) - 2020/06/02 20:11:47
Table '6' 8-max Seat #7 is the button
Seat 1: Hero (11,458 in chips)
Seat 2: 841f9992 (13,218 in chips)
Seat 3: 5d46d288 (8,672 in chips)
Seat 4: c1468789 (16,973 in chips)
Seat 5: ae0045c4 (8,358 in chips)
Seat 6: 4c7cfe42 (12,001 in chips)
Seat 7: c4607254 (7,641 in chips)
Seat 8: 4e885360 (17,631 in chips)
841f9992: posts the ante 36
4e885360: posts the ante 36
4c7cfe42: posts the ante 36
ae0045c4: posts the ante 36
5d46d288: posts the ante 36
c4607254: posts the ante 36
c1468789: posts the ante 36
Hero: posts the ante 36
4e885360: posts small blind 100
Hero: posts big blind 200
*** HOLE CARDS ***
Dealt to Hero [2d 2c]
Dealt to 841f9992 
Dealt to 5d46d288 
Dealt to c1468789 
Dealt to ae0045c4 
Dealt to 4c7cfe42 
Dealt to c4607254 
Dealt to 4e885360 
841f9992: folds
5d46d288: raises 300 to 500
c1468789: folds
ae0045c4: folds
4c7cfe42: folds
c4607254: folds
4e885360: folds
Hero: calls 300
*** FLOP *** [Ac 7s Qh]
Hero: checks
5d46d288: bets 458
Hero: folds
Uncalled bet (458) returned to 5d46d288
*** SHOWDOWN ***
5d46d288 collected 1,388 from pot
*** SUMMARY ***
Total pot 1,388
Board [Ac 7s Qh]
Seat 1: Hero (big blind) folded on the Flop
Seat 2: 841f9992 folded before Flop
Seat 3: 5d46d288 won (1,388)
Seat 4: c1468789 folded before Flop
Seat 5: ae0045c4 folded before Flop
Seat 6: 4c7cfe42 folded before Flop
Seat 7: c4607254 (button) folded before Flop
Seat 8: 4e885360 (small blind) folded before Flop


Poker Hand #TM247778149: Tournament #5259595, Daily Special $250 Hold'em No Limit - Level6 (125/250) - 2020/06/02 20:13:07
Table '6' 8-max Seat #8 is the button
Seat 1: Hero (10,922 in chips)
Seat 2: 841f9992 (13,182 in chips)
Seat 3: 5d46d288 (9,524 in chips)
Seat 4: c1468789 (16,937 in chips)
Seat 5: ae0045c4 (8,322 in chips)
Seat 6: 4c7cfe42 (11,965 in chips)
Seat 7: c4607254 (7,605 in chips)
Seat 8: 4e885360 (17,495 in chips)
841f9992: posts the ante 38
4e885360: posts the ante 38
4c7cfe42: posts the ante 38
ae0045c4: posts the ante 38
5d46d288: posts the ante 38
c4607254: posts the ante 38
c1468789: posts the ante 38
Hero: posts the ante 38
Hero: posts small blind 125
841f9992: posts big blind 250
*** HOLE CARDS ***
Dealt to Hero [5c 4s]
Dealt to 841f9992 
Dealt to 5d46d288 
Dealt to c1468789 
Dealt to ae0045c4 
Dealt to 4c7cfe42 
Dealt to c4607254 
Dealt to 4e885360 
5d46d288: folds
c1468789: raises 325 to 575
ae0045c4: folds
4c7cfe42: folds
c4607254: folds
4e885360: folds
Hero: folds
841f9992: calls 325
*** FLOP *** [9h 8c 6h]
841f9992: checks
c1468789: checks
*** TURN *** [9h 8c 6h] [7d]
841f9992: checks
c1468789: checks
*** RIVER *** [9h 8c 6h 7d] [Jd]
841f9992: checks
c1468789: checks
841f9992: shows [8s Kd] (Pair of Eights)
c1468789: shows [Ac Jc] (Pair of Jacks)
*** SHOWDOWN ***
c1468789 collected 1,579 from pot
*** SUMMARY ***
Total pot 1,579
Board [9h 8c 6h 7d Jd]
Seat 1: Hero (small blind) folded before Flop
Seat 2: 841f9992 (big blind) showed [Kd 8s] and lost with Pair of Eights
Seat 3: 5d46d288 folded before Flop
Seat 4: c1468789 showed [Ac Jc] and won (1,579) with Pair of Jacks
Seat 5: ae0045c4 folded before Flop
Seat 6: 4c7cfe42 folded before Flop
Seat 7: c4607254 folded before Flop
Seat 8: 4e885360 (button) folded before Flop


Poker Hand #TM247778336: Tournament #5259595, Daily Special $250 Hold'em No Limit - Level6 (125/250) - 2020/06/02 20:14:51
Table '6' 8-max Seat #1 is the button
Seat 1: Hero (10,759 in chips)
Seat 2: 841f9992 (12,569 in chips)
Seat 3: 5d46d288 (9,486 in chips)
Seat 4: c1468789 (17,903 in chips)
Seat 5: ae0045c4 (8,284 in chips)
Seat 6: 4c7cfe42 (11,927 in chips)
Seat 7: c4607254 (7,567 in chips)
Seat 8: 4e885360 (17,457 in chips)
841f9992: posts the ante 38
4e885360: posts the ante 38
4c7cfe42: posts the ante 38
ae0045c4: posts the ante 38
5d46d288: posts the ante 38
c4607254: posts the ante 38
c1468789: posts the ante 38
Hero: posts the ante 38
841f9992: posts small blind 125
5d46d288: posts big blind 250
*** HOLE CARDS ***
Dealt to Hero [8c 2c]
Dealt to 841f9992 
Dealt to 5d46d288 
Dealt to c1468789 
Dealt to ae0045c4 
Dealt to 4c7cfe42 
Dealt to c4607254 
Dealt to 4e885360 
c1468789: folds
ae0045c4: folds
4c7cfe42: folds
c4607254: folds
4e885360: raises 325 to 575
Hero: folds
841f9992: folds
5d46d288: calls 325
*** FLOP *** [Kc 3s 9c]
5d46d288: checks
4e885360: bets 521
5d46d288: folds
Uncalled bet (521) returned to 4e885360
*** SHOWDOWN ***
4e885360 collected 1,579 from pot
*** SUMMARY ***
Total pot 1,579
Board [Kc 3s 9c]
Seat 1: Hero (button) folded before Flop
Seat 2: 841f9992 (small blind) folded before Flop
Seat 3: 5d46d288 (big blind) folded on the Flop
Seat 4: c1468789 folded before Flop
Seat 5: ae0045c4 folded before Flop
Seat 6: 4c7cfe42 folded before Flop
Seat 7: c4607254 folded before Flop
Seat 8: 4e885360 won (1,579)


Poker Hand #TM247778464: Tournament #5259595, Daily Special $250 Hold'em No Limit - Level6 (125/250) - 2020/06/02 20:15:59
Table '6' 8-max Seat #2 is the button
Seat 1: Hero (10,721 in chips)
Seat 2: 841f9992 (12,406 in chips)
Seat 3: 5d46d288 (8,873 in chips)
Seat 4: c1468789 (17,865 in chips)
Seat 5: ae0045c4 (8,246 in chips)
Seat 6: 4c7cfe42 (11,889 in chips)
Seat 7: c4607254 (7,529 in chips)
Seat 8: 4e885360 (18,423 in chips)
841f9992: posts the ante 38
4e885360: posts the ante 38
4c7cfe42: posts the ante 38
ae0045c4: posts the ante 38
5d46d288: posts the ante 38
c4607254: posts the ante 38
c1468789: posts the ante 38
Hero: posts the ante 38
5d46d288: posts small blind 125
c1468789: posts big blind 250
*** HOLE CARDS ***
Dealt to Hero [Kd Th]
Dealt to 841f9992 
Dealt to 5d46d288 
Dealt to c1468789 
Dealt to ae0045c4 
Dealt to 4c7cfe42 
Dealt to c4607254 
Dealt to 4e885360 
ae0045c4: folds
4c7cfe42: folds
c4607254: folds
4e885360: folds
Hero: raises 300 to 550
841f9992: folds
5d46d288: folds
c1468789: calls 300
*** FLOP *** [2h Qc 9h]
c1468789: checks
Hero: bets 505
c1468789: calls 505
*** TURN *** [2h Qc 9h] [2d]
c1468789: checks
Hero: checks
*** RIVER *** [2h Qc 9h 2d] [Qh]
c1468789: bets 635
Hero: folds
Uncalled bet (635) returned to c1468789
*** SHOWDOWN ***
c1468789 collected 2,539 from pot
*** SUMMARY ***
Total pot 2,539
Board [2h Qc 9h 2d Qh]
Seat 1: Hero folded on the River
Seat 2: 841f9992 (button) folded before Flop
Seat 3: 5d46d288 (small blind) folded before Flop
Seat 4: c1468789 (big blind) won (2,539)
Seat 5: ae0045c4 folded before Flop
Seat 6: 4c7cfe42 folded before Flop
Seat 7: c4607254 folded before Flop
Seat 8: 4e885360 folded before Flop


Poker Hand #TM247778636: Tournament #5259595, Daily Special $250 Hold'em No Limit - Level6 (125/250) - 2020/06/02 20:17:40
Table '6' 8-max Seat #3 is the button
Seat 1: Hero (9,628 in chips)
Seat 2: 841f9992 (12,368 in chips)
Seat 3: 5d46d288 (8,710 in chips)
Seat 4: c1468789 (19,311 in chips)
Seat 5: ae0045c4 (8,208 in chips)
Seat 6: 4c7cfe42 (11,851 in chips)
Seat 7: c4607254 (7,491 in chips)
Seat 8: 4e885360 (18,385 in chips)
841f9992: posts the ante 38
4e885360: posts the ante 38
4c7cfe42: posts the ante 38
ae0045c4: posts the ante 38
5d46d288: posts the ante 38
c4607254: posts the ante 38
c1468789: posts the ante 38
Hero: posts the ante 38
c1468789: posts small blind 125
ae0045c4: posts big blind 250
*** HOLE CARDS ***
Dealt to Hero [8s 2d]
Dealt to 841f9992 
Dealt to 5d46d288 
Dealt to c1468789 
Dealt to ae0045c4 
Dealt to 4c7cfe42 
Dealt to c4607254 
Dealt to 4e885360 
4c7cfe42: folds
c4607254: folds
4e885360: folds
Hero: folds
841f9992: folds
5d46d288: calls 250
c1468789: calls 125
ae0045c4: checks
*** FLOP *** [Qd Jh 9c]
c1468789: checks
ae0045c4: checks
5d46d288: bets 348
c1468789: folds
ae0045c4: folds
Uncalled bet (348) returned to 5d46d288
*** SHOWDOWN ***
5d46d288 collected 1,054 from pot
*** SUMMARY ***
Total pot 1,054
Board [Qd Jh 9c]
Seat 1: Hero folded before Flop
Seat 2: 841f9992 folded before Flop
Seat 3: 5d46d288 (button) won (1,054)
Seat 4: c1468789 (small blind) folded on the Flop
Seat 5: ae0045c4 (big blind) folded on the Flop
Seat 6: 4c7cfe42 folded before Flop
Seat 7: c4607254 folded before Flop
Seat 8: 4e885360 folded before Flop


Poker Hand #TM247778841: Tournament #5259595, Daily Special $250 Hold'em No Limit - Level6 (125/250) - 2020/06/02 20:19:31
Table '6' 8-max Seat #4 is the button
Seat 1: Hero (9,590 in chips)
Seat 2: 841f9992 (12,330 in chips)
Seat 3: 5d46d288 (9,476 in chips)
Seat 4: c1468789 (19,023 in chips)
Seat 5: ae0045c4 (7,920 in chips)
Seat 6: 4c7cfe42 (11,813 in chips)
Seat 7: c4607254 (7,453 in chips)
Seat 8: 4e885360 (18,347 in chips)
841f9992: posts the ante 38
4e885360: posts the ante 38
4c7cfe42: posts the ante 38
ae0045c4: posts the ante 38
5d46d288: posts the ante 38
c4607254: posts the ante 38
c1468789: posts the ante 38
Hero: posts the ante 38
ae0045c4: posts small blind 125
4c7cfe42: posts big blind 250
*** HOLE CARDS ***
Dealt to Hero [Qd 9s]
Dealt to 841f9992 
Dealt to 5d46d288 
Dealt to c1468789 
Dealt to ae0045c4 
Dealt to 4c7cfe42 
Dealt to c4607254 
Dealt to 4e885360 
c4607254: folds
4e885360: folds
Hero: folds
841f9992: raises 275 to 525
5d46d288: raises 1,525 to 2,050
c1468789: folds
ae0045c4: folds
4c7cfe42: folds
841f9992: calls 1,525
*** FLOP *** [4h 8c Jh]
841f9992: checks
5d46d288: bets 1,577
841f9992: folds
Uncalled bet (1,577) returned to 5d46d288
*** SHOWDOWN ***
5d46d288 collected 4,779 from pot
*** SUMMARY ***
Total pot 4,779
Board [4h 8c Jh]
Seat 1: Hero folded before Flop
Seat 2: 841f9992 folded on the Flop
Seat 3: 5d46d288 won (4,779)
Seat 4: c1468789 (button) folded before Flop
Seat 5: ae0045c4 (small blind) folded before Flop
Seat 6: 4c7cfe42 (big blind) folded before Flop
Seat 7: c4607254 folded before Flop
Seat 8: 4e885360 folded before Flop


Poker Hand #TM247779000: Tournament #5259595, Daily Special $250 Hold'em No Limit - Level6 (125/250) - 2020/06/02 20:20:57
Table '6' 8-max Seat #5 is the button
Seat 1: Hero (9,552 in chips)
Seat 2: 841f9992 (10,242 in chips)
Seat 3: 5d46d288 (12,167 in chips)
Seat 4: c1468789 (18,985 in chips)
Seat 5: ae0045c4 (7,757 in chips)
Seat 6: 4c7cfe42 (11,525 in chips)
Seat 7: c4607254 (7,415 in chips)
Seat 8: 4e885360 (18,309 in chips)
841f9992: posts the ante 38
4e885360: posts the ante 38
4c7cfe42: posts the ante 38
ae0045c4: posts the ante 38
5d46d288: posts the ante 38
c4607254: posts the ante 38
c1468789: posts the ante 38
Hero: posts the ante 38
4c7cfe42: posts small blind 125
c4607254: posts big blind 250
*** HOLE CARDS ***
Dealt to Hero [9c 2s]
Dealt to 841f9992 
Dealt to 5d46d288 
Dealt to c1468789 
Dealt to ae0045c4 
Dealt to 4c7cfe42 
Dealt to c4607254 
Dealt to 4e885360 
4e885360: folds
Hero: folds
841f9992: folds
5d46d288: raises 375 to 625
c1468789: folds
ae0045c4: folds
4c7cfe42: folds
c4607254: folds
Uncalled bet (375) returned to 5d46d288
*** SHOWDOWN ***
5d46d288 collected 929 from pot
*** SUMMARY ***
Total pot 929
Seat 1: Hero folded before Flop
Seat 2: 841f9992 folded before Flop
Seat 3: 5d46d288 collected (929)
Seat 4: c1468789 folded before Flop
Seat 5: ae0045c4 (button) folded before Flop
Seat 6: 4c7cfe42 (small blind) folded before Flop
Seat 7: c4607254 (big blind) folded before Flop
Seat 8: 4e885360 folded before Flop


Poker Hand #TM247849124: Tournament #5259595, Daily Special $250 Hold'em No Limit - Level6 (125/250) - 2020/06/02 20:21:58
Table '6' 8-max Seat #6 is the button
Seat 1: Hero (9,514 in chips)
Seat 2: 841f9992 (10,204 in chips)
Seat 3: 5d46d288 (12,808 in chips)
Seat 4: c1468789 (18,947 in chips)
Seat 5: ae0045c4 (7,719 in chips)
Seat 6: 4c7cfe42 (11,362 in chips)
Seat 7: c4607254 (7,127 in chips)
Seat 8: 4e885360 (18,271 in chips)
841f9992: posts the ante 38
4e885360: posts the ante 38
4c7cfe42: posts the ante 38
ae0045c4: posts the ante 38
5d46d288: posts the ante 38
c4607254: posts the ante 38
c1468789: posts the ante 38
Hero: posts the ante 38
c4607254: posts small blind 125
4e885360: posts big blind 250
*** HOLE CARDS ***
Dealt to Hero [7c 6c]
Dealt to 841f9992 
Dealt to 5d46d288 
Dealt to c1468789 
Dealt to ae0045c4 
Dealt to 4c7cfe42 
Dealt to c4607254 
Dealt to 4e885360 
Hero: folds
841f9992: folds
5d46d288: folds
c1468789: folds
ae0045c4: folds
4c7cfe42: folds
c4607254: calls 125
4e885360: checks
*** FLOP *** [Tc 2s Kh]
c4607254: bets 250
4e885360: calls 250
*** TURN *** [Tc 2s Kh] [8s]
c4607254: checks
4e885360: bets 775
c4607254: folds
Uncalled bet (775) returned to 4e885360
*** SHOWDOWN ***
4e885360 collected 1,304 from pot
*** SUMMARY ***
Total pot 1,304
Board [Tc 2s Kh 8s]
Seat 1: Hero folded before Flop
Seat 2: 841f9992 folded before Flop
Seat 3: 5d46d288 folded before Flop
Seat 4: c1468789 folded before Flop
Seat 5: ae0045c4 folded before Flop
Seat 6: 4c7cfe42 (button) folded before Flop
Seat 7: c4607254 (small blind) folded on the Turn
Seat 8: 4e885360 (big blind) won (1,304)


Poker Hand #TM247849375: Tournament #5259595, Daily Special $250 Hold'em No Limit - Level6 (125/250) - 2020/06/02 20:24:15
Table '6' 8-max Seat #7 is the button
Seat 1: Hero (9,476 in chips)
Seat 2: 841f9992 (10,166 in chips)
Seat 3: 5d46d288 (12,770 in chips)
Seat 4: c1468789 (18,909 in chips)
Seat 5: ae0045c4 (7,681 in chips)
Seat 6: 4c7cfe42 (11,324 in chips)
Seat 7: c4607254 (6,589 in chips)
Seat 8: 4e885360 (19,037 in chips)
841f9992: posts the ante 38
4e885360: posts the ante 38
4c7cfe42: posts the ante 38
ae0045c4: posts the ante 38
5d46d288: posts the ante 38
c4607254: posts the ante 38
c1468789: posts the ante 38
Hero: posts the ante 38
4e885360: posts small blind 125
Hero: posts big blind 250
*** HOLE CARDS ***
Dealt to Hero [9h 7c]
Dealt to 841f9992 
Dealt to 5d46d288 
Dealt to c1468789 
Dealt to ae0045c4 
Dealt to 4c7cfe42 
Dealt to c4607254 
Dealt to 4e885360 
841f9992: folds
5d46d288: folds
c1468789: raises 325 to 575
ae0045c4: raises 7,068 to 7,643 and is all-in
4c7cfe42: folds
c4607254: folds
4e885360: folds
Hero: folds
c1468789: folds
Uncalled bet (7,068) returned to ae0045c4
*** SHOWDOWN ***
ae0045c4 collected 1,829 from pot
*** SUMMARY ***
Total pot 1,829
Seat 1: Hero (big blind) folded before Flop
Seat 2: 841f9992 folded before Flop
Seat 3: 5d46d288 folded before Flop
Seat 4: c1468789 folded before Flop
Seat 5: ae0045c4 collected (1,829)
Seat 6: 4c7cfe42 folded before Flop
Seat 7: c4607254 (button) folded before Flop
Seat 8: 4e885360 (small blind) folded before Flop


Poker Hand #TM247849493: Tournament #5259595, Daily Special $250 Hold'em No Limit - Level7 (150/300) - 2020/06/02 20:25:18
Table '6' 8-max Seat #8 is the button
Seat 1: Hero (9,188 in chips)
Seat 2: 841f9992 (10,128 in chips)
Seat 3: 5d46d288 (12,732 in chips)
Seat 4: c1468789 (18,296 in chips)
Seat 5: ae0045c4 (8,897 in chips)
Seat 6: 4c7cfe42 (11,286 in chips)
Seat 7: c4607254 (6,551 in chips)
Seat 8: 4e885360 (18,874 in chips)
841f9992: posts the ante 38
4e885360: posts the ante 38
4c7cfe42: posts the ante 38
ae0045c4: posts the ante 38
5d46d288: posts the ante 38
c4607254: posts the ante 38
c1468789: posts the ante 38
Hero: posts the ante 38
Hero: posts small blind 125
841f9992: posts big blind 250
*** HOLE CARDS ***
Dealt to Hero [8s 3s]
Dealt to 841f9992 
Dealt to 5d46d288 
Dealt to c1468789 
Dealt to ae0045c4 
Dealt to 4c7cfe42 
Dealt to c4607254 
Dealt to 4e885360 
5d46d288: folds
c1468789: folds
ae0045c4: folds
4c7cfe42: raises 300 to 550
c4607254: folds
4e885360: folds
Hero: folds
841f9992: calls 300
*** FLOP *** [3h 7h 8c]
841f9992: checks
4c7cfe42: checks
*** TURN *** [3h 7h 8c] [4c]
841f9992: bets 1,648
4c7cfe42: calls 1,648
*** RIVER *** [3h 7h 8c 4c] [9h]
841f9992: checks
4c7cfe42: checks
841f9992: shows [5c 6h] (Nines-High Straight)
4c7cfe42: shows [Tc Ac] (Ace-High)
*** SHOWDOWN ***
841f9992 collected 4,825 from pot
*** SUMMARY ***
Total pot 4,825
Board [3h 7h 8c 4c 9h]
Seat 1: Hero (small blind) folded before Flop
Seat 2: 841f9992 (big blind) showed [6h 5c] and won (4,825) with Nines-High Straight
Seat 3: 5d46d288 folded before Flop
Seat 4: c1468789 folded before Flop
Seat 5: ae0045c4 folded before Flop
Seat 6: 4c7cfe42 showed [Ac Tc] and lost with Ace-High
Seat 7: c4607254 folded before Flop
Seat 8: 4e885360 (button) folded before Flop


Poker Hand #TM247849667: Tournament #5259595, Daily Special $250 Hold'em No Limit - Level7 (150/300) - 2020/06/02 20:26:50
Table '6' 8-max Seat #1 is the button
Seat 1: Hero (9,025 in chips)
Seat 2: 841f9992 (12,717 in chips)
Seat 3: 5d46d288 (12,694 in chips)
Seat 4: c1468789 (18,258 in chips)
Seat 5: ae0045c4 (8,859 in chips)
Seat 6: 4c7cfe42 (9,050 in chips)
Seat 7: c4607254 (6,513 in chips)
Seat 8: 4e885360 (18,836 in chips)
841f9992: posts the ante 45
4e885360: posts the ante 45
4c7cfe42: posts the ante 45
ae0045c4: posts the ante 45
5d46d288: posts the ante 45
c4607254: posts the ante 45
c1468789: posts the ante 45
Hero: posts the ante 45
841f9992: posts small blind 150
5d46d288: posts big blind 300
*** HOLE CARDS ***
Dealt to Hero [Kh 7c]
Dealt to 841f9992 
Dealt to 5d46d288 
Dealt to c1468789 
Dealt to ae0045c4 
Dealt to 4c7cfe42 
Dealt to c4607254 
Dealt to 4e885360 
c1468789: raises 390 to 690
ae0045c4: folds
4c7cfe42: folds
c4607254: folds
4e885360: folds
Hero: folds
841f9992: folds
5d46d288: calls 390
*** FLOP *** [3h 5c Qd]
5d46d288: checks
c1468789: bets 472
5d46d288: folds
Uncalled bet (472) returned to c1468789
*** SHOWDOWN ***
c1468789 collected 1,890 from pot
*** SUMMARY ***
Total pot 1,890
Board [3h 5c Qd]
Seat 1: Hero (button) folded before Flop
Seat 2: 841f9992 (small blind) folded before Flop
Seat 3: 5d46d288 (big blind) folded on the Flop
Seat 4: c1468789 won (1,890)
Seat 5: ae0045c4 folded before Flop
Seat 6: 4c7cfe42 folded before Flop
Seat 7: c4607254 folded before Flop
Seat 8: 4e885360 folded before Flop


Poker Hand #TM247849766: Tournament #5259595, Daily Special $250 Hold'em No Limit - Level7 (150/300) - 2020/06/02 20:27:43
Table '6' 8-max Seat #2 is the button
Seat 1: Hero (8,980 in chips)
Seat 2: 841f9992 (12,522 in chips)
Seat 3: 5d46d288 (11,959 in chips)
Seat 4: c1468789 (19,413 in chips)
Seat 5: ae0045c4 (8,814 in chips)
Seat 6: 4c7cfe42 (9,005 in chips)
Seat 7: c4607254 (6,468 in chips)
Seat 8: 4e885360 (18,791 in chips)
841f9992: posts the ante 45
4e885360: posts the ante 45
4c7cfe42: posts the ante 45
ae0045c4: posts the ante 45
5d46d288: posts the ante 45
c4607254: posts the ante 45
c1468789: posts the ante 45
Hero: posts the ante 45
5d46d288: posts small blind 150
c1468789: posts big blind 300
*** HOLE CARDS ***
Dealt to Hero [Kh 9s]
Dealt to 841f9992 
Dealt to 5d46d288 
Dealt to c1468789 
Dealt to ae0045c4 
Dealt to 4c7cfe42 
Dealt to c4607254 
Dealt to 4e885360 
ae0045c4: folds
4c7cfe42: folds
c4607254: folds
4e885360: raises 390 to 690
Hero: folds
841f9992: folds
5d46d288: folds
c1468789: folds
Uncalled bet (390) returned to 4e885360
*** SHOWDOWN ***
4e885360 collected 1,110 from pot
*** SUMMARY ***
Total pot 1,110
Seat 1: Hero folded before Flop
Seat 2: 841f9992 (button) folded before Flop
Seat 3: 5d46d288 (small blind) folded before Flop
Seat 4: c1468789 (big blind) folded before Flop
Seat 5: ae0045c4 folded before Flop
Seat 6: 4c7cfe42 folded before Flop
Seat 7: c4607254 folded before Flop
Seat 8: 4e885360 collected (1,110)


Poker Hand #TM247849828: Tournament #5259595, Daily Special $250 Hold'em No Limit - Level7 (150/300) - 2020/06/02 20:28:23
Table '6' 8-max Seat #4 is the button
Seat 1: Hero (8,935 in chips)
Seat 2: 841f9992 (12,477 in chips)
Seat 4: c1468789 (19,068 in chips)
Seat 5: ae0045c4 (8,769 in chips)
Seat 6: 4c7cfe42 (8,960 in chips)
Seat 7: c4607254 (6,423 in chips)
Seat 8: 4e885360 (19,556 in chips)
841f9992: posts the ante 45
4e885360: posts the ante 45
4c7cfe42: posts the ante 45
ae0045c4: posts the ante 45
c4607254: posts the ante 45
c1468789: posts the ante 45
Hero: posts the ante 45
ae0045c4: posts small blind 150
4c7cfe42: posts big blind 300
*** HOLE CARDS ***
Dealt to Hero [4d 2h]
Dealt to 841f9992 
Dealt to c1468789 
Dealt to ae0045c4 
Dealt to 4c7cfe42 
Dealt to c4607254 
Dealt to 4e885360 
c4607254: raises 300 to 600
4e885360: folds
Hero: folds
841f9992: folds
c1468789: folds
ae0045c4: folds
4c7cfe42: folds
Uncalled bet (300) returned to c4607254
*** SHOWDOWN ***
c4607254 collected 1,065 from pot
*** SUMMARY ***
Total pot 1,065
Seat 1: Hero folded before Flop
Seat 2: 841f9992 folded before Flop
Seat 4: c1468789 (button) folded before Flop
Seat 5: ae0045c4 (small blind) folded before Flop
Seat 6: 4c7cfe42 (big blind) folded before Flop
Seat 7: c4607254 collected (1,065)
Seat 8: 4e885360 folded before Flop


Poker Hand #TM247849952: Tournament #5259595, Daily Special $250 Hold'em No Limit - Level7 (150/300) - 2020/06/02 20:29:30
Table '6' 8-max Seat #5 is the button
Seat 1: Hero (8,890 in chips)
Seat 2: 841f9992 (12,432 in chips)
Seat 3: cf859ba5 (10,000 in chips)
Seat 4: c1468789 (19,023 in chips)
Seat 5: ae0045c4 (8,574 in chips)
Seat 6: 4c7cfe42 (8,615 in chips)
Seat 7: c4607254 (7,143 in chips)
Seat 8: 4e885360 (19,511 in chips)
841f9992: posts the ante 45
4e885360: posts the ante 45
4c7cfe42: posts the ante 45
ae0045c4: posts the ante 45
c4607254: posts the ante 45
c1468789: posts the ante 45
cf859ba5: posts the ante 45
Hero: posts the ante 45
4c7cfe42: posts small blind 150
c4607254: posts big blind 300
*** HOLE CARDS ***
Dealt to Hero [Th 9h]
Dealt to 841f9992 
Dealt to cf859ba5 
Dealt to c1468789 
Dealt to ae0045c4 
Dealt to 4c7cfe42 
Dealt to c4607254 
Dealt to 4e885360 
4e885360: folds
Hero: raises 360 to 660
841f9992: folds
cf859ba5: folds
c1468789: folds
ae0045c4: folds
4c7cfe42: folds
c4607254: folds
Uncalled bet (360) returned to Hero
*** SHOWDOWN ***
Hero collected 1,110 from pot
*** SUMMARY ***
Total pot 1,110
Seat 1: Hero collected (1,110)
Seat 2: 841f9992 folded before Flop
Seat 3: cf859ba5 folded before Flop
Seat 4: c1468789 folded before Flop
Seat 5: ae0045c4 (button) folded before Flop
Seat 6: 4c7cfe42 (small blind) folded before Flop
Seat 7: c4607254 (big blind) folded before Flop
Seat 8: 4e885360 folded before Flop


Poker Hand #TM247850024: Tournament #5259595, Daily Special $250 Hold'em No Limit - Level7 (150/300) - 2020/06/02 20:30:14
Table '6' 8-max Seat #6 is the button
Seat 1: Hero (9,655 in chips)
Seat 2: 841f9992 (12,387 in chips)
Seat 3: cf859ba5 (9,955 in chips)
Seat 4: c1468789 (18,978 in chips)
Seat 5: ae0045c4 (8,529 in chips)
Seat 6: 4c7cfe42 (8,420 in chips)
Seat 7: c4607254 (6,798 in chips)
Seat 8: 4e885360 (19,466 in chips)
841f9992: posts the ante 45
4e885360: posts the ante 45
4c7cfe42: posts the ante 45
ae0045c4: posts the ante 45
c4607254: posts the ante 45
c1468789: posts the ante 45
cf859ba5: posts the ante 45
Hero: posts the ante 45
c4607254: posts small blind 150
4e885360: posts big blind 300
*** HOLE CARDS ***
Dealt to Hero [Th 5c]
Dealt to 841f9992 
Dealt to cf859ba5 
Dealt to c1468789 
Dealt to ae0045c4 
Dealt to 4c7cfe42 
Dealt to c4607254 
Dealt to 4e885360 
Hero: folds
841f9992: raises 330 to 630
cf859ba5: raises 1,230 to 1,860
c1468789: folds
ae0045c4: raises 6,624 to 8,484 and is all-in
4c7cfe42: folds
c4607254: folds
4e885360: folds
841f9992: folds
cf859ba5: folds
Uncalled bet (6,624) returned to ae0045c4
*** SHOWDOWN ***
ae0045c4 collected 5,160 from pot
*** SUMMARY ***
Total pot 5,160
Seat 1: Hero folded before Flop
Seat 2: 841f9992 folded before Flop
Seat 3: cf859ba5 folded before Flop
Seat 4: c1468789 folded before Flop
Seat 5: ae0045c4 collected (5,160)
Seat 6: 4c7cfe42 (button) folded before Flop
Seat 7: c4607254 (small blind) folded before Flop
Seat 8: 4e885360 (big blind) folded before Flop


Poker Hand #TM247850116: Tournament #5259595, Daily Special $250 Hold'em No Limit - Level7 (150/300) - 2020/06/02 20:31:12
Table '6' 8-max Seat #7 is the button
Seat 1: Hero (9,610 in chips)
Seat 2: 841f9992 (11,712 in chips)
Seat 3: cf859ba5 (8,050 in chips)
Seat 4: c1468789 (18,933 in chips)
Seat 5: ae0045c4 (11,784 in chips)
Seat 6: 4c7cfe42 (8,375 in chips)
Seat 7: c4607254 (6,603 in chips)
Seat 8: 4e885360 (19,121 in chips)
841f9992: posts the ante 45
4e885360: posts the ante 45
4c7cfe42: posts the ante 45
ae0045c4: posts the ante 45
c4607254: posts the ante 45
c1468789: posts the ante 45
cf859ba5: posts the ante 45
Hero: posts the ante 45
4e885360: posts small blind 150
Hero: posts big blind 300
*** HOLE CARDS ***
Dealt to Hero [Jh 9c]
Dealt to 841f9992 
Dealt to cf859ba5 
Dealt to c1468789 
Dealt to ae0045c4 
Dealt to 4c7cfe42 
Dealt to c4607254 
Dealt to 4e885360 
841f9992: folds
cf859ba5: raises 390 to 690
c1468789: folds
ae0045c4: folds
4c7cfe42: calls 690
c4607254: folds
4e885360: folds
Hero: calls 390
*** FLOP *** [Th 5h 4d]
Hero: checks
cf859ba5: checks
4c7cfe42: checks
*** TURN *** [Th 5h 4d] [Js]
Hero: bets 851
cf859ba5: raises 1,713 to 2,564
4c7cfe42: calls 2,564
Hero: folds
*** RIVER *** [Th 5h 4d Js] [6h]
cf859ba5: checks
4c7cfe42: checks
cf859ba5: shows [Kc Jc] (Pair of Jacks)
4c7cfe42: shows [Jd Ah] (Pair of Jacks)
*** SHOWDOWN ***
4c7cfe42 collected 8,559 from pot
*** SUMMARY ***
Total pot 8,559
Board [Th 5h 4d Js 6h]
Seat 1: Hero (big blind) folded on the Turn
Seat 2: 841f9992 folded before Flop
Seat 3: cf859ba5 showed [Kc Jc] and lost with Pair of Jacks
Seat 4: c1468789 folded before Flop
Seat 5: ae0045c4 folded before Flop
Seat 6: 4c7cfe42 showed [Ah Jd] and won (8,559) with Pair of Jacks
Seat 7: c4607254 (button) folded before Flop
Seat 8: 4e885360 (small blind) folded before Flop


Poker Hand #TM247850292: Tournament #5259595, Daily Special $250 Hold'em No Limit - Level7 (150/300) - 2020/06/02 20:33:11
Table '6' 8-max Seat #8 is the button
Seat 1: Hero (8,024 in chips)
Seat 2: 841f9992 (11,667 in chips)
Seat 3: cf859ba5 (4,751 in chips)
Seat 4: c1468789 (18,888 in chips)
Seat 5: ae0045c4 (11,739 in chips)
Seat 6: 4c7cfe42 (13,635 in chips)
Seat 7: c4607254 (6,558 in chips)
Seat 8: 4e885360 (18,926 in chips)
841f9992: posts the ante 45
4e885360: posts the ante 45
4c7cfe42: posts the ante 45
ae0045c4: posts the ante 45
c4607254: posts the ante 45
c1468789: posts the ante 45
cf859ba5: posts the ante 45
Hero: posts the ante 45
Hero: posts small blind 150
841f9992: posts big blind 300
*** HOLE CARDS ***
Dealt to Hero [Qh 3s]
Dealt to 841f9992 
Dealt to cf859ba5 
Dealt to c1468789 
Dealt to ae0045c4 
Dealt to 4c7cfe42 
Dealt to c4607254 
Dealt to 4e885360 
cf859ba5: folds
c1468789: folds
ae0045c4: folds
4c7cfe42: folds
c4607254: raises 6,213 to 6,513 and is all-in
4e885360: folds
Hero: folds
841f9992: folds
Uncalled bet (6,213) returned to c4607254
*** SHOWDOWN ***
c4607254 collected 1,110 from pot
*** SUMMARY ***
Total pot 1,110
Seat 1: Hero (small blind) folded before Flop
Seat 2: 841f9992 (big blind) folded before Flop
Seat 3: cf859ba5 folded before Flop
Seat 4: c1468789 folded before Flop
Seat 5: ae0045c4 folded before Flop
Seat 6: 4c7cfe42 folded before Flop
Seat 7: c4607254 collected (1,110)
Seat 8: 4e885360 (button) folded before Flop


Poker Hand #TM247850346: Tournament #5259595, Daily Special $250 Hold'em No Limit - Level7 (150/300) - 2020/06/02 20:33:47
Table '6' 8-max Seat #1 is the button
Seat 1: Hero (7,829 in chips)
Seat 2: 841f9992 (11,322 in chips)
Seat 3: cf859ba5 (4,706 in chips)
Seat 4: c1468789 (18,843 in chips)
Seat 5: ae0045c4 (11,694 in chips)
Seat 6: 4c7cfe42 (13,590 in chips)
Seat 7: c4607254 (7,323 in chips)
Seat 8: 4e885360 (18,881 in chips)
841f9992: posts the ante 45
4e885360: posts the ante 45
4c7cfe42: posts the ante 45
ae0045c4: posts the ante 45
c4607254: posts the ante 45
c1468789: posts the ante 45
cf859ba5: posts the ante 45
Hero: posts the ante 45
841f9992: posts small blind 150
cf859ba5: posts big blind 300
*** HOLE CARDS ***
Dealt to Hero [8d 6s]
Dealt to 841f9992 
Dealt to cf859ba5 
Dealt to c1468789 
Dealt to ae0045c4 
Dealt to 4c7cfe42 
Dealt to c4607254 
Dealt to 4e885360 
c1468789: folds
ae0045c4: folds
4c7cfe42: raises 300 to 600
c4607254: folds
4e885360: folds
Hero: folds
841f9992: folds
cf859ba5: folds
Uncalled bet (300) returned to 4c7cfe42
*** SHOWDOWN ***
4c7cfe42 collected 1,110 from pot
*** SUMMARY ***
Total pot 1,110
Seat 1: Hero (button) folded before Flop
Seat 2: 841f9992 (small blind) folded before Flop
Seat 3: cf859ba5 (big blind) folded before Flop
Seat 4: c1468789 folded before Flop
Seat 5: ae0045c4 folded before Flop
Seat 6: 4c7cfe42 collected (1,110)
Seat 7: c4607254 folded before Flop
Seat 8: 4e885360 folded before Flop


Poker Hand #TM247850417: Tournament #5259595, Daily Special $250 Hold'em No Limit - Level7 (150/300) - 2020/06/02 20:34:34
Table '6' 8-max Seat #2 is the button
Seat 1: Hero (7,784 in chips)
Seat 2: 841f9992 (11,127 in chips)
Seat 3: cf859ba5 (4,361 in chips)
Seat 4: c1468789 (18,798 in chips)
Seat 5: ae0045c4 (11,649 in chips)
Seat 6: 4c7cfe42 (14,355 in chips)
Seat 7: c4607254 (7,278 in chips)
Seat 8: 4e885360 (18,836 in chips)
841f9992: posts the ante 45
4e885360: posts the ante 45
4c7cfe42: posts the ante 45
ae0045c4: posts the ante 45
c4607254: posts the ante 45
c1468789: posts the ante 45
cf859ba5: posts the ante 45
Hero: posts the ante 45
cf859ba5: posts small blind 150
c1468789: posts big blind 300
*** HOLE CARDS ***
Dealt to Hero [Qd Qc]
Dealt to 841f9992 
Dealt to cf859ba5 
Dealt to c1468789 
Dealt to ae0045c4 
Dealt to 4c7cfe42 
Dealt to c4607254 
Dealt to 4e885360 
ae0045c4: folds
4c7cfe42: folds
c4607254: raises 300 to 600
4e885360: folds
Hero: raises 7,139 to 7,739 and is all-in
841f9992: folds
cf859ba5: folds
c1468789: folds
c4607254: calls 6,633 and is all-in
Uncalled bet (506) returned to Hero
Hero: shows [Qc Qd]
c4607254: shows [As Kd]
*** FLOP *** [7d 8s 9s]
*** TURN *** [7d 8s 9s] [Ks]
*** RIVER *** [7d 8s 9s Ks] [2h]
*** SHOWDOWN ***
c4607254 collected 15,276 from pot
*** SUMMARY ***
Total pot 15,276
Board [7d 8s 9s Ks 2h]
Seat 1: Hero showed [Qd Qc] and lost with Pair of Queens
Seat 2: 841f9992 (button) folded before Flop
Seat 3: cf859ba5 (small blind) folded before Flop
Seat 4: c1468789 (big blind) folded before Flop
Seat 5: ae0045c4 folded before Flop
Seat 6: 4c7cfe42 folded before Flop
Seat 7: c4607254 showed [As Kd] and won (15,276) with Pair of Kings
Seat 8: 4e885360 folded before Flop


Poker Hand #TM247850550: Tournament #5259595, Daily Special $250 Hold'em No Limit - Level7 (150/300) - 2020/06/02 20:35:51
Table '6' 8-max Seat #3 is the button
Seat 1: Hero (506 in chips)
Seat 2: 841f9992 (11,082 in chips)
Seat 3: cf859ba5 (4,166 in chips)
Seat 4: c1468789 (18,453 in chips)
Seat 5: ae0045c4 (11,604 in chips)
Seat 6: 4c7cfe42 (14,310 in chips)
Seat 7: c4607254 (15,276 in chips)
Seat 8: 4e885360 (18,791 in chips)
841f9992: posts the ante 45
4e885360: posts the ante 45
4c7cfe42: posts the ante 45
ae0045c4: posts the ante 45
c4607254: posts the ante 45
c1468789: posts the ante 45
cf859ba5: posts the ante 45
Hero: posts the ante 45
c1468789: posts small blind 150
ae0045c4: posts big blind 300
*** HOLE CARDS ***
Dealt to Hero [6h 5c]
Dealt to 841f9992 
Dealt to cf859ba5 
Dealt to c1468789 
Dealt to ae0045c4 
Dealt to 4c7cfe42 
Dealt to c4607254 
Dealt to 4e885360 
4c7cfe42: raises 300 to 600
c4607254: folds
4e885360: folds
Hero: folds
841f9992: folds
cf859ba5: folds
c1468789: calls 450
ae0045c4: raises 10,959 to 11,559 and is all-in
4c7cfe42: folds
c1468789: folds
Uncalled bet (10,959) returned to ae0045c4
*** SHOWDOWN ***
ae0045c4 collected 2,160 from pot
*** SUMMARY ***
Total pot 2,160
Seat 1: Hero folded before Flop
Seat 2: 841f9992 folded before Flop
Seat 3: cf859ba5 (button) folded before Flop
Seat 4: c1468789 (small blind) folded before Flop
Seat 5: ae0045c4 (big blind) collected (2,160)
Seat 6: 4c7cfe42 folded before Flop
Seat 7: c4607254 folded before Flop
Seat 8: 4e885360 folded before Flop


Poker Hand #TM247850640: Tournament #5259595, Daily Special $250 Hold'em No Limit - Level7 (150/300) - 2020/06/02 20:36:59
Table '6' 8-max Seat #4 is the button
Seat 1: Hero (461 in chips)
Seat 2: 841f9992 (11,037 in chips)
Seat 3: cf859ba5 (4,121 in chips)
Seat 4: c1468789 (17,808 in chips)
Seat 5: ae0045c4 (13,119 in chips)
Seat 6: 4c7cfe42 (13,665 in chips)
Seat 7: c4607254 (15,231 in chips)
Seat 8: 4e885360 (18,746 in chips)
841f9992: posts the ante 45
4e885360: posts the ante 45
4c7cfe42: posts the ante 45
ae0045c4: posts the ante 45
c4607254: posts the ante 45
c1468789: posts the ante 45
cf859ba5: posts the ante 45
Hero: posts the ante 45
ae0045c4: posts small blind 150
4c7cfe42: posts big blind 300
*** HOLE CARDS ***
Dealt to Hero [Ad 6h]
Dealt to 841f9992 
Dealt to cf859ba5 
Dealt to c1468789 
Dealt to ae0045c4 
Dealt to 4c7cfe42 
Dealt to c4607254 
Dealt to 4e885360 
c4607254: folds
4e885360: folds
Hero: raises 116 to 416 and is all-in
841f9992: folds
cf859ba5: folds
c1468789: folds
ae0045c4: folds
4c7cfe42: calls 116
Hero: shows [6h Ad]
4c7cfe42: shows [Qc Jd]
*** FLOP *** [4h 8s Qs]
*** TURN *** [4h 8s Qs] [3s]
*** RIVER *** [4h 8s Qs 3s] [Ah]
*** SHOWDOWN ***
Hero collected 1,342 from pot
*** SUMMARY ***
Total pot 1,342
Board [4h 8s Qs 3s Ah]
Seat 1: Hero showed [Ad 6h] and won (1,342) with Pair of Aces
Seat 2: 841f9992 folded before Flop
Seat 3: cf859ba5 folded before Flop
Seat 4: c1468789 (button) folded before Flop
Seat 5: ae0045c4 (small blind) folded before Flop
Seat 6: 4c7cfe42 (big blind) showed [Qc Jd] and lost with Pair of Queens
Seat 7: c4607254 folded before Flop
Seat 8: 4e885360 folded before Flop


Poker Hand #TM247850728: Tournament #5259595, Daily Special $250 Hold'em No Limit - Level8 (200/400) - 2020/06/02 20:37:58
Table '6' 8-max Seat #5 is the button
Seat 1: Hero (1,342 in chips)
Seat 2: 841f9992 (10,992 in chips)
Seat 3: cf859ba5 (4,076 in chips)
Seat 4: c1468789 (17,763 in chips)
Seat 5: ae0045c4 (12,924 in chips)
Seat 6: 4c7cfe42 (13,204 in chips)
Seat 7: c4607254 (15,186 in chips)
Seat 8: 4e885360 (18,701 in chips)
841f9992: posts the ante 45
4e885360: posts the ante 45
4c7cfe42: posts the ante 45
ae0045c4: posts the ante 45
c4607254: posts the ante 45
c1468789: posts the ante 45
cf859ba5: posts the ante 45
Hero: posts the ante 45
4c7cfe42: posts small blind 150
c4607254: posts big blind 300
*** HOLE CARDS ***
Dealt to Hero [Qd 2d]
Dealt to 841f9992 
Dealt to cf859ba5 
Dealt to c1468789 
Dealt to ae0045c4 
Dealt to 4c7cfe42 
Dealt to c4607254 
Dealt to 4e885360 
4e885360: raises 390 to 690
Hero: folds
841f9992: folds
cf859ba5: folds
c1468789: folds
ae0045c4: calls 690
4c7cfe42: folds
c4607254: folds
*** FLOP *** [8c 2s 8d]
4e885360: bets 1,274
ae0045c4: folds
Uncalled bet (1,274) returned to 4e885360
*** SHOWDOWN ***
4e885360 collected 2,190 from pot
*** SUMMARY ***
Total pot 2,190
Board [8c 2s 8d]
Seat 1: Hero folded before Flop
Seat 2: 841f9992 folded before Flop
Seat 3: cf859ba5 folded before Flop
Seat 4: c1468789 folded before Flop
Seat 5: ae0045c4 (button) folded on the Flop
Seat 6: 4c7cfe42 (small blind) folded before Flop
Seat 7: c4607254 (big blind) folded before Flop
Seat 8: 4e885360 won (2,190)


Poker Hand #TM247850818: Tournament #5259595, Daily Special $250 Hold'em No Limit - Level8 (200/400) - 2020/06/02 20:39:01
Table '6' 8-max Seat #6 is the button
Seat 1: Hero (1,297 in chips)
Seat 2: 841f9992 (10,947 in chips)
Seat 3: cf859ba5 (4,031 in chips)
Seat 4: c1468789 (17,718 in chips)
Seat 5: ae0045c4 (12,189 in chips)
Seat 6: 4c7cfe42 (13,009 in chips)
Seat 7: c4607254 (14,841 in chips)
Seat 8: 4e885360 (20,156 in chips)
841f9992: posts the ante 60
4e885360: posts the ante 60
4c7cfe42: posts the ante 60
ae0045c4: posts the ante 60
c4607254: posts the ante 60
c1468789: posts the ante 60
cf859ba5: posts the ante 60
Hero: posts the ante 60
c4607254: posts small blind 200
4e885360: posts big blind 400
*** HOLE CARDS ***
Dealt to Hero [Qc Jc]
Dealt to 841f9992 
Dealt to cf859ba5 
Dealt to c1468789 
Dealt to ae0045c4 
Dealt to 4c7cfe42 
Dealt to c4607254 
Dealt to 4e885360 
Hero: raises 837 to 1,237 and is all-in
841f9992: folds
cf859ba5: folds
c1468789: folds
ae0045c4: folds
4c7cfe42: folds
c4607254: folds
4e885360: calls 837
Hero: shows [Qc Jc]
4e885360: shows [Jd Ts]
*** FLOP *** [7h 5h 5c]
*** TURN *** [7h 5h 5c] [2s]
*** RIVER *** [7h 5h 5c 2s] [Kc]
*** SHOWDOWN ***
Hero collected 3,154 from pot
*** SUMMARY ***
Total pot 3,154
Board [7h 5h 5c 2s Kc]
Seat 1: Hero showed [Qc Jc] and won (3,154) with Pair of Fives
Seat 2: 841f9992 folded before Flop
Seat 3: cf859ba5 folded before Flop
Seat 4: c1468789 folded before Flop
Seat 5: ae0045c4 folded before Flop
Seat 6: 4c7cfe42 (button) folded before Flop
Seat 7: c4607254 (small blind) folded before Flop
Seat 8: 4e885360 (big blind) showed [Jd Ts] and lost with Pair of Fives


Poker Hand #TM247850906: Tournament #5259595, Daily Special $250 Hold'em No Limit - Level8 (200/400) - 2020/06/02 20:39:54
Table '6' 8-max Seat #7 is the button
Seat 1: Hero (3,154 in chips)
Seat 2: 841f9992 (10,887 in chips)
Seat 3: cf859ba5 (3,971 in chips)
Seat 4: c1468789 (17,658 in chips)
Seat 5: ae0045c4 (12,129 in chips)
Seat 6: 4c7cfe42 (12,949 in chips)
Seat 7: c4607254 (14,581 in chips)
Seat 8: 4e885360 (18,859 in chips)
841f9992: posts the ante 60
4e885360: posts the ante 60
4c7cfe42: posts the ante 60
ae0045c4: posts the ante 60
c4607254: posts the ante 60
c1468789: posts the ante 60
cf859ba5: posts the ante 60
Hero: posts the ante 60
4e885360: posts small blind 200
Hero: posts big blind 400
*** HOLE CARDS ***
Dealt to Hero [Ks Jh]
Dealt to 841f9992 
Dealt to cf859ba5 
Dealt to c1468789 
Dealt to ae0045c4 
Dealt to 4c7cfe42 
Dealt to c4607254 
Dealt to 4e885360 
841f9992: folds
cf859ba5: folds
c1468789: folds
ae0045c4: folds
4c7cfe42: folds
c4607254: folds
4e885360: raises 18,399 to 18,799 and is all-in
Hero: calls 2,694 and is all-in
Uncalled bet (15,705) returned to 4e885360
4e885360: shows [As 3d]
Hero: shows [Jh Ks]
*** FLOP *** [Th Ac 4s]
*** TURN *** [Th Ac 4s] [Td]
*** RIVER *** [Th Ac 4s Td] [2h]
*** SHOWDOWN ***
4e885360 collected 6,668 from pot
*** SUMMARY ***
Total pot 6,668
Board [Th Ac 4s Td 2h]
Seat 1: Hero (big blind) showed [Ks Jh] and lost with Pair of Tens
Seat 2: 841f9992 folded before Flop
Seat 3: cf859ba5 folded before Flop
Seat 4: c1468789 folded before Flop
Seat 5: ae0045c4 folded before Flop
Seat 6: 4c7cfe42 folded before Flop
Seat 7: c4607254 (button) folded before Flop
Seat 8: 4e885360 (small blind) showed [As 3d] and won (6,668) with Pair of Aces and Pair of Tens


