PokerStars Game #35838989654:  5 Card Draw Limit ($0.10/$0.20 USD) - 2009/11/25 14:12:43 ET
Table 'Laodica IV' 6-max Seat #2 is the button
Seat 1: francois 712 ($1.53 in chips) 
Seat 2: vatt110 ($2.41 in chips) 
Seat 3: dantho ($1.76 in chips) 
Seat 4: Hero ($4 in chips) 
Seat 6: Postman15 ($1 in chips) 
dantho: posts small blind $0.05
Hero: posts big blind $0.10
*** DEALING HANDS ***
Dealt to Hero [Td Th 6h 4h 2s]
Postman15: folds 
francois 712: folds 
vatt110: raises $0.10 to $0.20
dantho: folds 
Hero: calls $0.10
Hero: discards 1 card [2s]
Dealt to Hero [Td Th 6h 4h] [Ks]
vatt110: discards 3 cards
Hero: checks 
vatt110: checks 
*** SHOW DOWN ***
Hero: shows [Td Th 6h 4h Ks] (a pair of Tens)
vatt110: shows [Qd 5c Qs Ac 4d] (a pair of Queens)
vatt110 collected $0.43 from pot
*** SUMMARY ***
Total pot $0.45 | Rake $0.02 
Seat 1: francois 712 folded before the Draw (didn't bet)
Seat 2: vatt110 (button) showed [Qd 5c Qs Ac 4d] and won ($0.43) with a pair of Queens
Seat 3: dantho (small blind) folded before the Draw
Seat 4: Hero (big blind) showed [Td Th 6h 4h Ks] and lost with a pair of Tens
Seat 6: Postman15 folded before the Draw (didn't bet)



PokerStars Game #35839017616:  5 Card Draw Limit ($0.10/$0.20 USD) - 2009/11/25 14:13:19 ET
Table 'Laodica IV' 6-max Seat #3 is the button
Seat 1: francois 712 ($1.53 in chips) 
Seat 2: vatt110 ($2.64 in chips) 
Seat 3: dantho ($1.71 in chips) 
Seat 4: Hero ($3.80 in chips) 
Seat 6: Postman15 ($1 in chips) 
Hero: posts small blind $0.05
Postman15: posts big blind $0.10
*** DEALING HANDS ***
Dealt to Hero [4s 2d 8s 7c 5h]
francois 712: folds 
vatt110: folds 
dantho: raises $0.10 to $0.20
Hero: folds 
Postman15: folds 
Uncalled bet ($0.10) returned to dantho
dantho collected $0.25 from pot
dantho: doesn't show hand 
*** SUMMARY ***
Total pot $0.25 | Rake $0 
Seat 1: francois 712 folded before the Draw (didn't bet)
Seat 2: vatt110 folded before the Draw (didn't bet)
Seat 3: dantho (button) collected ($0.25)
Seat 4: Hero (small blind) folded before the Draw
Seat 6: Postman15 (big blind) folded before the Draw



PokerStars Game #35839033367:  5 Card Draw Limit ($0.10/$0.20 USD) - 2009/11/25 14:13:39 ET
Table 'Laodica IV' 6-max Seat #4 is the button
Seat 1: francois 712 ($1.53 in chips) 
Seat 2: vatt110 ($2.64 in chips) 
Seat 3: dantho ($1.86 in chips) 
Seat 4: Hero ($3.75 in chips) 
Seat 6: Postman15 ($0.90 in chips) 
Postman15: posts small blind $0.05
francois 712: posts big blind $0.10
*** DEALING HANDS ***
Dealt to Hero [8h 7h Tc 4h Qd]
vatt110: folds 
dantho: raises $0.10 to $0.20
Hero: calls $0.20
Postman15: folds 
francois 712: folds 
dantho: discards 1 card
Hero: discards 2 cards [Tc Qd]
Dealt to Hero [8h 7h 4h] [Kd 5s]
dantho: checks 
Hero: bets $0.20
dantho: calls $0.20
*** SHOW DOWN ***
Hero: shows [8h 7h Kd 4h 5s] (high card King)
dantho: shows [Th Jc 8c Ts 8d] (two pair, Tens and Eights)
dantho collected $0.91 from pot
*** SUMMARY ***
Total pot $0.95 | Rake $0.04 
Seat 1: francois 712 (big blind) folded before the Draw
Seat 2: vatt110 folded before the Draw (didn't bet)
Seat 3: dantho showed [Th Jc 8c Ts 8d] and won ($0.91) with two pair, Tens and Eights
Seat 4: Hero (button) showed [8h 7h Kd 4h 5s] and lost with high card King
Seat 6: Postman15 (small blind) folded before the Draw



PokerStars Game #35839052257:  5 Card Draw Limit ($0.10/$0.20 USD) - 2009/11/25 14:14:04 ET
Table 'Laodica IV' 6-max Seat #6 is the button
Seat 1: francois 712 ($1.43 in chips) 
Seat 2: vatt110 ($2.64 in chips) 
Seat 3: dantho ($2.37 in chips) 
Seat 4: Hero ($3.35 in chips) 
Seat 6: Postman15 ($0.85 in chips) 
francois 712: posts small blind $0.05
vatt110: posts big blind $0.10
*** DEALING HANDS ***
Dealt to Hero [6d 8s 2c Td 5c]
dantho: folds 
Hero: folds 
Postman15: folds 
francois 712: calls $0.05
vatt110: checks 
francois 712: discards 3 cards
vatt110: discards 3 cards
francois 712: checks 
vatt110: checks 
*** SHOW DOWN ***
francois 712: shows [Th Qc 7c 5h Ah] (high card Ace)
vatt110: mucks hand 
francois 712 collected $0.19 from pot
*** SUMMARY ***
Total pot $0.20 | Rake $0.01 
Seat 1: francois 712 (small blind) showed [Th Qc 7c 5h Ah] and won ($0.19) with high card Ace
Seat 2: vatt110 (big blind) mucked [4h Ks 3s Jc 7h]
Seat 3: dantho folded before the Draw (didn't bet)
Seat 4: Hero folded before the Draw (didn't bet)
Seat 6: Postman15 (button) folded before the Draw (didn't bet)



PokerStars Game #35839069182:  5 Card Draw Limit ($0.10/$0.20 USD) - 2009/11/25 14:14:25 ET
Table 'Laodica IV' 6-max Seat #1 is the button
Seat 1: francois 712 ($1.52 in chips) 
Seat 2: vatt110 ($2.54 in chips) 
Seat 3: dantho ($2.37 in chips) 
Seat 4: Hero ($3.35 in chips) 
Seat 6: Postman15 ($0.85 in chips) 
vatt110: posts small blind $0.05
dantho: posts big blind $0.10
*** DEALING HANDS ***
Dealt to Hero [8d 8h 7h 2d 3h]
Hero: folds 
Postman15: folds 
francois 712: folds 
vatt110: folds 
Uncalled bet ($0.05) returned to dantho
dantho collected $0.10 from pot
dantho: doesn't show hand 
*** SUMMARY ***
Total pot $0.10 | Rake $0 
Seat 1: francois 712 (button) folded before the Draw (didn't bet)
Seat 2: vatt110 (small blind) folded before the Draw
Seat 3: dantho (big blind) collected ($0.10)
Seat 4: Hero folded before the Draw (didn't bet)
Seat 6: Postman15 folded before the Draw (didn't bet)



PokerStars Game #35839082075:  5 Card Draw Limit ($0.10/$0.20 USD) - 2009/11/25 14:14:42 ET
Table 'Laodica IV' 6-max Seat #2 is the button
Seat 1: francois 712 ($1.52 in chips) 
Seat 2: vatt110 ($2.49 in chips) 
Seat 3: dantho ($2.42 in chips) 
Seat 4: Hero ($3.35 in chips) 
Seat 6: Postman15 ($0.85 in chips) 
dantho: posts small blind $0.05
Hero: posts big blind $0.10
*** DEALING HANDS ***
Dealt to Hero [Jc 9h Ks 7h 3h]
Postman15: calls $0.10
francois 712: raises $0.10 to $0.20
vatt110: calls $0.20
dantho: folds 
Hero: folds 
Postman15: calls $0.10
Postman15: discards 3 cards
francois 712: discards 1 card
vatt110: discards 1 card
Postman15: bets $0.20
francois 712: calls $0.20
vatt110: folds 
*** SHOW DOWN ***
Postman15: shows [Ad Ac As 6c 9c] (three of a kind, Aces)
francois 712: mucks hand 
Postman15 collected $1.10 from pot
*** SUMMARY ***
Total pot $1.15 | Rake $0.05 
Seat 1: francois 712 mucked [Qh Qc Js Kc Kh]
Seat 2: vatt110 (button) folded after the Draw
Seat 3: dantho (small blind) folded before the Draw
Seat 4: Hero (big blind) folded before the Draw
Seat 6: Postman15 showed [Ad Ac As 6c 9c] and won ($1.10) with three of a kind, Aces



PokerStars Game #35839114737:  5 Card Draw Limit ($0.10/$0.20 USD) - 2009/11/25 14:15:24 ET
Table 'Laodica IV' 6-max Seat #3 is the button
Seat 1: francois 712 ($1.12 in chips) 
Seat 2: vatt110 ($2.29 in chips) 
Seat 3: dantho ($2.37 in chips) 
Seat 4: Hero ($3.25 in chips) 
Seat 6: Postman15 ($1.55 in chips) 
Hero: posts small blind $0.05
Postman15: posts big blind $0.10
*** DEALING HANDS ***
Dealt to Hero [4c Qh 4d 2h Kd]
francois 712: raises $0.10 to $0.20
vatt110: folds 
dantho: folds 
Hero: folds 
Postman15: calls $0.10
Postman15: discards 1 card
francois 712: discards 3 cards
Postman15: checks 
francois 712: bets $0.20
Postman15: calls $0.20
*** SHOW DOWN ***
francois 712: shows [7h Js Ks Kc 7c] (two pair, Kings and Sevens)
Postman15: shows [6c Ah 2d As 6s] (two pair, Aces and Sixes)
Postman15 collected $0.81 from pot
*** SUMMARY ***
Total pot $0.85 | Rake $0.04 
Seat 1: francois 712 showed [7h Js Ks Kc 7c] and lost with two pair, Kings and Sevens
Seat 2: vatt110 folded before the Draw (didn't bet)
Seat 3: dantho (button) folded before the Draw (didn't bet)
Seat 4: Hero (small blind) folded before the Draw
Seat 6: Postman15 (big blind) showed [6c Ah 2d As 6s] and won ($0.81) with two pair, Aces and Sixes



PokerStars Game #35839131252:  5 Card Draw Limit ($0.10/$0.20 USD) - 2009/11/25 14:15:46 ET
Table 'Laodica IV' 6-max Seat #4 is the button
Seat 1: francois 712 ($0.72 in chips) 
Seat 2: vatt110 ($2.29 in chips) 
Seat 3: dantho ($2.37 in chips) 
Seat 4: Hero ($3.20 in chips) 
Seat 6: Postman15 ($1.96 in chips) 
Gemma702 was removed from the table for failing to post
Postman15: posts small blind $0.05
francois 712: posts big blind $0.10
*** DEALING HANDS ***
Dealt to Hero [8c 4h Ks Kd 7c]
vatt110: folds 
dantho: folds 
Hero: calls $0.10
Postman15: calls $0.05
francois 712: checks 
Jana50 joins the table at seat #5 
Postman15: discards 3 cards
francois 712: discards 3 cards
Hero: discards 3 cards [8c 4h 7c]
Dealt to Hero [Ks Kd] [Qd 5d 2h]
Postman15: checks 
francois 712: checks 
Hero: bets $0.20
Postman15: folds 
francois 712: folds 
Uncalled bet ($0.20) returned to Hero
Hero collected $0.29 from pot
*** SUMMARY ***
Total pot $0.30 | Rake $0.01 
Seat 1: francois 712 (big blind) folded after the Draw
Seat 2: vatt110 folded before the Draw (didn't bet)
Seat 3: dantho folded before the Draw (didn't bet)
Seat 4: Hero (button) collected ($0.29)
Seat 6: Postman15 (small blind) folded after the Draw



PokerStars Game #35839155320:  5 Card Draw Limit ($0.10/$0.20 USD) - 2009/11/25 14:16:17 ET
Table 'Laodica IV' 6-max Seat #6 is the button
Seat 1: francois 712 ($0.62 in chips) 
Seat 2: vatt110 ($2.29 in chips) 
Seat 3: dantho ($2.37 in chips) 
Seat 4: Hero ($3.39 in chips) 
Seat 6: Postman15 ($1.86 in chips) 
francois 712: posts small blind $0.05
vatt110: posts big blind $0.10
Jana50: sits out 
*** DEALING HANDS ***
Dealt to Hero [9c 9d 4s 3d Jh]
dantho: folds 
Hero: raises $0.10 to $0.20
Postman15: folds 
francois 712: folds 
vatt110: folds 
Uncalled bet ($0.10) returned to Hero
Hero collected $0.25 from pot
*** SUMMARY ***
Total pot $0.25 | Rake $0 
Seat 1: francois 712 (small blind) folded before the Draw
Seat 2: vatt110 (big blind) folded before the Draw
Seat 3: dantho folded before the Draw (didn't bet)
Seat 4: Hero collected ($0.25)
Seat 6: Postman15 (button) folded before the Draw (didn't bet)



PokerStars Game #35839165896:  5 Card Draw Limit ($0.10/$0.20 USD) - 2009/11/25 14:16:32 ET
Table 'Laodica IV' 6-max Seat #1 is the button
Seat 1: francois 712 ($0.57 in chips) 
Seat 2: vatt110 ($2.19 in chips) 
Seat 3: dantho ($2.37 in chips) 
Seat 4: Hero ($3.54 in chips) 
Seat 6: Postman15 ($1.86 in chips) 
vatt110: posts small blind $0.05
dantho: posts big blind $0.10
Jana50: sits out 
*** DEALING HANDS ***
Dealt to Hero [7s 6c Qh 6d 7h]
Hero: raises $0.10 to $0.20
Postman15: folds 
francois 712: folds 
vatt110: folds 
dantho: raises $0.10 to $0.30
Hero: calls $0.10
dantho: stands pat 
Hero: discards 1 card [Qh]
Dealt to Hero [7s 6c 6d 7h] [8c]
dantho: bets $0.20
Hero: calls $0.20
*** SHOW DOWN ***
dantho: shows [3s Js 5s 6s 2s] (a flush, Jack high)
Hero: mucks hand 
dantho collected $1 from pot
*** SUMMARY ***
Total pot $1.05 | Rake $0.05 
Seat 1: francois 712 (button) folded before the Draw (didn't bet)
Seat 2: vatt110 (small blind) folded before the Draw
Seat 3: dantho (big blind) showed [3s Js 5s 6s 2s] and won ($1) with a flush, Jack high
Seat 4: Hero mucked [7s 6c 8c 6d 7h]
Seat 6: Postman15 folded before the Draw (didn't bet)



PokerStars Game #35839203571:  5 Card Draw Limit ($0.10/$0.20 USD) - 2009/11/25 14:17:22 ET
Table 'Laodica IV' 6-max Seat #2 is the button
Seat 1: francois 712 ($0.57 in chips) 
Seat 2: vatt110 ($2.14 in chips) 
Seat 3: dantho ($2.87 in chips) 
Seat 4: Hero ($3.04 in chips) 
Seat 6: Postman15 ($1.86 in chips) 
dantho: posts small blind $0.05
Hero: posts big blind $0.10
Jana50: sits out 
*** DEALING HANDS ***
Dealt to Hero [3h 4s 7h 8c 6d]
Postman15: folds 
francois 712: calls $0.10
vatt110: calls $0.10
dantho: folds 
Hero: checks 
Hero: discards 1 card [3h]
Dealt to Hero [4s 7h 8c 6d] [6s]
francois 712: discards 1 card
vatt110: discards 3 cards
Hero: checks 
francois 712: checks 
vatt110: checks 
*** SHOW DOWN ***
Hero: shows [6s 4s 7h 8c 6d] (a pair of Sixes)
francois 712: mucks hand 
vatt110: shows [3d Jh 8h Jc 2c] (a pair of Jacks)
vatt110 collected $0.34 from pot
*** SUMMARY ***
Total pot $0.35 | Rake $0.01 
Seat 1: francois 712 mucked [5s Js Ks Qc Ts]
Seat 2: vatt110 (button) showed [3d Jh 8h Jc 2c] and won ($0.34) with a pair of Jacks
Seat 3: dantho (small blind) folded before the Draw
Seat 4: Hero (big blind) showed [6s 4s 7h 8c 6d] and lost with a pair of Sixes
Seat 6: Postman15 folded before the Draw (didn't bet)



PokerStars Game #35839231732:  5 Card Draw Limit ($0.10/$0.20 USD) - 2009/11/25 14:17:57 ET
Table 'Laodica IV' 6-max Seat #3 is the button
Seat 1: francois 712 ($0.47 in chips) 
Seat 2: vatt110 ($2.38 in chips) 
Seat 3: dantho ($2.82 in chips) 
Seat 4: Hero ($2.94 in chips) 
Seat 5: Jana50 ($4 in chips) 
Seat 6: Postman15 ($1.86 in chips) 
Hero: posts small blind $0.05
Jana50: posts big blind $0.10
*** DEALING HANDS ***
Dealt to Hero [Ad 2c Ts 4s Tc]
Postman15: folds 
francois 712: folds 
vatt110: folds 
dantho: folds 
Hero: calls $0.05
Jana50: checks 
Hero: discards 2 cards [2c 4s]
Dealt to Hero [Ad Ts Tc] [Ac Jc]
Jana50: discards 1 card
Hero: bets $0.20
Jana50: folds 
Uncalled bet ($0.20) returned to Hero
Hero collected $0.19 from pot
*** SUMMARY ***
Total pot $0.20 | Rake $0.01 
Seat 1: francois 712 folded before the Draw (didn't bet)
Seat 2: vatt110 folded before the Draw (didn't bet)
Seat 3: dantho (button) folded before the Draw (didn't bet)
Seat 4: Hero (small blind) collected ($0.19)
Seat 5: Jana50 (big blind) folded after the Draw
Seat 6: Postman15 folded before the Draw (didn't bet)



PokerStars Game #35839248508:  5 Card Draw Limit ($0.10/$0.20 USD) - 2009/11/25 14:18:19 ET
Table 'Laodica IV' 6-max Seat #4 is the button
Seat 1: francois 712 ($0.47 in chips) 
Seat 2: vatt110 ($2.38 in chips) 
Seat 3: dantho ($2.82 in chips) 
Seat 4: Hero ($3.03 in chips) 
Seat 5: Jana50 ($3.90 in chips) 
Seat 6: Postman15 ($1.86 in chips) 
Jana50: posts small blind $0.05
Postman15: posts big blind $0.10
*** DEALING HANDS ***
Dealt to Hero [6s Kc Qh Kh 5h]
francois 712: calls $0.10
vatt110: folds 
dantho: folds 
Hero: calls $0.10
Jana50: folds 
Postman15: checks 
Postman15: discards 3 cards
francois 712: discards 1 card
Hero: discards 3 cards [6s Qh 5h]
Dealt to Hero [Kc Kh] [Tc 7c 8h]
Postman15: checks 
francois 712: checks 
Hero: bets $0.20
Postman15: calls $0.20
francois 712: folds 
*** SHOW DOWN ***
Hero: shows [Tc Kc 7c Kh 8h] (a pair of Kings)
Postman15: shows [Ad 8c Qs Kd Ac] (a pair of Aces)
Postman15 collected $0.72 from pot
*** SUMMARY ***
Total pot $0.75 | Rake $0.03 
Seat 1: francois 712 folded after the Draw
Seat 2: vatt110 folded before the Draw (didn't bet)
Seat 3: dantho folded before the Draw (didn't bet)
Seat 4: Hero (button) showed [Tc Kc 7c Kh 8h] and lost with a pair of Kings
Seat 5: Jana50 (small blind) folded before the Draw
Seat 6: Postman15 (big blind) showed [Ad 8c Qs Kd Ac] and won ($0.72) with a pair of Aces



PokerStars Game #35839278018:  5 Card Draw Limit ($0.10/$0.20 USD) - 2009/11/25 14:18:59 ET
Table 'Laodica IV' 6-max Seat #5 is the button
Seat 1: francois 712 ($0.37 in chips) 
Seat 2: vatt110 ($2.38 in chips) 
Seat 3: dantho ($2.82 in chips) 
Seat 4: Hero ($2.73 in chips) 
Seat 5: Jana50 ($3.85 in chips) 
Seat 6: Postman15 ($2.28 in chips) 
Postman15: posts small blind $0.05
francois 712: posts big blind $0.10
*** DEALING HANDS ***
Dealt to Hero [2c 4h 9c Qs 3d]
vatt110: raises $0.10 to $0.20
dantho: folds 
Hero: folds 
Jana50: folds 
Postman15: folds 
francois 712: calls $0.10
francois 712: discards 1 card
vatt110: discards 3 cards
francois 712: bets $0.17 and is all-in
vatt110: calls $0.17
*** SHOW DOWN ***
francois 712: shows [Qh Jh 9d 6c Tc] (high card Queen)
vatt110: shows [Ks 7h Ad Kd 8h] (a pair of Kings)
vatt110 collected $0.76 from pot
*** SUMMARY ***
Total pot $0.79 | Rake $0.03 
Seat 1: francois 712 (big blind) showed [Qh Jh 9d 6c Tc] and lost with high card Queen
Seat 2: vatt110 showed [Ks 7h Ad Kd 8h] and won ($0.76) with a pair of Kings
Seat 3: dantho folded before the Draw (didn't bet)
Seat 4: Hero folded before the Draw (didn't bet)
Seat 5: Jana50 (button) folded before the Draw (didn't bet)
Seat 6: Postman15 (small blind) folded before the Draw



PokerStars Game #35839303429:  5 Card Draw Limit ($0.10/$0.20 USD) - 2009/11/25 14:19:34 ET
Table 'Laodica IV' 6-max Seat #6 is the button
Seat 2: vatt110 ($2.77 in chips) 
Seat 3: dantho ($2.82 in chips) 
Seat 4: Hero ($2.73 in chips) 
Seat 5: Jana50 ($3.85 in chips) 
Seat 6: Postman15 ($2.23 in chips) 
vatt110: posts small blind $0.05
dantho: posts big blind $0.10
*** DEALING HANDS ***
Dealt to Hero [Qd Ah Js 3s 5c]
Hero: folds 
Jana50: calls $0.10
francois 712 leaves the table
Postman15: calls $0.10
vatt110: folds 
dantho: checks 
dantho: discards 1 card
Jana50: discards 1 card
Postman15: discards 3 cards
dantho: bets $0.20
Jana50: calls $0.20
Postman15: folds 
*** SHOW DOWN ***
dantho: shows [Kh Jc Qs Td 9d] (a straight, Nine to King)
Jana50: mucks hand 
dantho collected $0.72 from pot
*** SUMMARY ***
Total pot $0.75 | Rake $0.03 
Seat 2: vatt110 (small blind) folded before the Draw
Seat 3: dantho (big blind) showed [Kh Jc Qs Td 9d] and won ($0.72) with a straight, Nine to King
Seat 4: Hero folded before the Draw (didn't bet)
Seat 5: Jana50 mucked [3d 2h As 4h 2s]
Seat 6: Postman15 (button) folded after the Draw



PokerStars Game #35839326969:  5 Card Draw Limit ($0.10/$0.20 USD) - 2009/11/25 14:20:10 ET
Table 'Laodica IV' 6-max Seat #2 is the button
Seat 2: vatt110 ($2.72 in chips) 
Seat 3: dantho ($3.24 in chips) 
Seat 4: Hero ($2.73 in chips) 
Seat 5: Jana50 ($3.55 in chips) 
Seat 6: Postman15 ($2.13 in chips) 
dantho: posts small blind $0.05
Hero: posts big blind $0.10
*** DEALING HANDS ***
Dealt to Hero [8s Td 5h 5d Jd]
Jana50: folds 
Postman15: folds 
vatt110: calls $0.10
dantho: folds 
Hero: checks 
Hero: discards 3 cards [8s Td Jd]
Dealt to Hero [5h 5d] [3c 5c 9c]
vatt110: discards 3 cards
Hero: bets $0.20
vatt110: folds 
Uncalled bet ($0.20) returned to Hero
Hero collected $0.24 from pot
*** SUMMARY ***
Total pot $0.25 | Rake $0.01 
Seat 2: vatt110 (button) folded after the Draw
Seat 3: dantho (small blind) folded before the Draw
Seat 4: Hero (big blind) collected ($0.24)
Seat 5: Jana50 folded before the Draw (didn't bet)
Seat 6: Postman15 folded before the Draw (didn't bet)



PokerStars Game #35839348926:  5 Card Draw Limit ($0.10/$0.20 USD) - 2009/11/25 14:20:38 ET
Table 'Laodica IV' 6-max Seat #3 is the button
Seat 2: vatt110 ($2.62 in chips) 
Seat 3: dantho ($3.19 in chips) 
Seat 4: Hero ($2.87 in chips) 
Seat 5: Jana50 ($3.55 in chips) 
Seat 6: Postman15 ($2.13 in chips) 
Hero: posts small blind $0.05
Jana50: posts big blind $0.10
*** DEALING HANDS ***
Dealt to Hero [4s 6c 2d 7c 8h]
Postman15: folds 
vatt110: folds 
dantho: raises $0.10 to $0.20
Hero: folds 
Jana50: folds 
Uncalled bet ($0.10) returned to dantho
dantho collected $0.25 from pot
dantho: doesn't show hand 
*** SUMMARY ***
Total pot $0.25 | Rake $0 
Seat 2: vatt110 folded before the Draw (didn't bet)
Seat 3: dantho (button) collected ($0.25)
Seat 4: Hero (small blind) folded before the Draw
Seat 5: Jana50 (big blind) folded before the Draw
Seat 6: Postman15 folded before the Draw (didn't bet)



PokerStars Game #35839361919:  5 Card Draw Limit ($0.10/$0.20 USD) - 2009/11/25 14:20:55 ET
Table 'Laodica IV' 6-max Seat #4 is the button
Seat 2: vatt110 ($2.62 in chips) 
Seat 3: dantho ($3.34 in chips) 
Seat 4: Hero ($2.82 in chips) 
Seat 5: Jana50 ($3.45 in chips) 
Seat 6: Postman15 ($2.13 in chips) 
Jana50: posts small blind $0.05
Postman15: posts big blind $0.10
*** DEALING HANDS ***
Dealt to Hero [Kh 4d Th 9d 2c]
vatt110: folds 
dantho: folds 
Hero: raises $0.10 to $0.20
Jana50: folds 
triggerbks joins the table at seat #1 
Postman15: folds 
Uncalled bet ($0.10) returned to Hero
Hero collected $0.25 from pot
*** SUMMARY ***
Total pot $0.25 | Rake $0 
Seat 2: vatt110 folded before the Draw (didn't bet)
Seat 3: dantho folded before the Draw (didn't bet)
Seat 4: Hero (button) collected ($0.25)
Seat 5: Jana50 (small blind) folded before the Draw
Seat 6: Postman15 (big blind) folded before the Draw



PokerStars Game #35839378137:  5 Card Draw Limit ($0.10/$0.20 USD) - 2009/11/25 14:21:17 ET
Table 'Laodica IV' 6-max Seat #5 is the button
Seat 1: triggerbks ($4 in chips) 
Seat 2: vatt110 ($2.62 in chips) 
Seat 3: dantho ($3.34 in chips) 
Seat 4: Hero ($2.97 in chips) 
Seat 5: Jana50 ($3.40 in chips) 
Seat 6: Postman15 ($2.03 in chips) 
Postman15: posts small blind $0.05
triggerbks: posts big blind $0.10
*** DEALING HANDS ***
Dealt to Hero [Qh 7s 4c Jh Tc]
vatt110: folds 
dantho: calls $0.10
Hero: folds 
Jana50: folds 
Postman15: calls $0.05
vatt110 leaves the table
triggerbks: raises $0.10 to $0.20
dantho: calls $0.10
Postman15: calls $0.10
Postman15: discards 1 card
triggerbks: discards 1 card
dantho: discards 3 cards
Postman15: checks 
triggerbks: bets $0.20
dantho: folds 
Postman15: calls $0.20
*** SHOW DOWN ***
triggerbks: shows [9c 5c 5s 3d 9s] (two pair, Nines and Fives)
Postman15: shows [Th 2c Qs Qd Ts] (two pair, Queens and Tens)
Postman15 collected $0.96 from pot
*** SUMMARY ***
Total pot $1 | Rake $0.04 
Seat 1: triggerbks (big blind) showed [9c 5c 5s 3d 9s] and lost with two pair, Nines and Fives
Seat 2: vatt110 folded before the Draw (didn't bet)
Seat 3: dantho folded after the Draw
Seat 4: Hero folded before the Draw (didn't bet)
Seat 5: Jana50 (button) folded before the Draw (didn't bet)
Seat 6: Postman15 (small blind) showed [Th 2c Qs Qd Ts] and won ($0.96) with two pair, Queens and Tens



PokerStars Game #35839401421:  5 Card Draw Limit ($0.10/$0.20 USD) - 2009/11/25 14:21:45 ET
Table 'Laodica IV' 6-max Seat #6 is the button
Seat 1: triggerbks ($3.60 in chips) 
Seat 3: dantho ($3.14 in chips) 
Seat 4: Hero ($2.97 in chips) 
Seat 5: Jana50 ($3.40 in chips) 
Seat 6: Postman15 ($2.59 in chips) 
triggerbks: posts small blind $0.05
dantho: posts big blind $0.10
*** DEALING HANDS ***
Dealt to Hero [8h Tc 9d 9s Td]
Hero: raises $0.10 to $0.20
Jana50: folds 
Postman15: folds 
triggerbks: folds 
dantho: calls $0.10
dantho: discards 1 card
Hero: discards 1 card [8h]
Dealt to Hero [Tc 9d 9s Td] [8c]
dantho: checks 
Hero: bets $0.20
dantho: raises $0.20 to $0.40
Hero: calls $0.20
*** SHOW DOWN ***
dantho: shows [5s 9h 7c 6c 8s] (a straight, Five to Nine)
Hero: mucks hand 
dantho collected $1.19 from pot
*** SUMMARY ***
Total pot $1.25 | Rake $0.06 
Seat 1: triggerbks (small blind) folded before the Draw
Seat 3: dantho (big blind) showed [5s 9h 7c 6c 8s] and won ($1.19) with a straight, Five to Nine
Seat 4: Hero mucked [8c Tc 9d 9s Td]
Seat 5: Jana50 folded before the Draw (didn't bet)
Seat 6: Postman15 (button) folded before the Draw (didn't bet)



PokerStars Game #35839419390:  5 Card Draw Limit ($0.10/$0.20 USD) - 2009/11/25 14:22:08 ET
Table 'Laodica IV' 6-max Seat #1 is the button
Seat 1: triggerbks ($3.55 in chips) 
Seat 3: dantho ($3.73 in chips) 
Seat 4: Hero ($2.37 in chips) 
Seat 5: Jana50 ($3.40 in chips) 
Seat 6: Postman15 ($2.59 in chips) 
dantho: posts small blind $0.05
Hero: posts big blind $0.10
*** DEALING HANDS ***
Dealt to Hero [9c Tc 2c 7h Qs]
Jana50: folds 
Jana50 leaves the table
Postman15: folds 
triggerbks: folds 
dantho: calls $0.05
Hero: checks 
dantho: discards 3 cards
trixr4dough joins the table at seat #2 
Hero: discards 2 cards [2c 7h]
Dealt to Hero [9c Tc Qs] [Jd 3c]
dantho: checks 
Hero: checks 
*** SHOW DOWN ***
dantho: shows [8s 4s 2d Ah 8d] (a pair of Eights)
Hero: mucks hand 
dantho collected $0.19 from pot
*** SUMMARY ***
Total pot $0.20 | Rake $0.01 
Seat 1: triggerbks (button) folded before the Draw (didn't bet)
Seat 3: dantho (small blind) showed [8s 4s 2d Ah 8d] and won ($0.19) with a pair of Eights
Seat 4: Hero (big blind) mucked [9c Tc Jd 3c Qs]
Seat 5: Jana50 folded before the Draw (didn't bet)
Seat 6: Postman15 folded before the Draw (didn't bet)



PokerStars Game #35839446861:  5 Card Draw Limit ($0.10/$0.20 USD) - 2009/11/25 14:22:42 ET
Table 'Laodica IV' 6-max Seat #3 is the button
Seat 1: triggerbks ($3.55 in chips) 
Seat 3: dantho ($3.82 in chips) 
Seat 4: Hero ($2.27 in chips) 
Seat 6: Postman15 ($2.59 in chips) 
Hero: posts small blind $0.05
Postman15: posts big blind $0.10
trixr4dough: sits out 
*** DEALING HANDS ***
Dealt to Hero [Td 7c 3s Tc 4d]
triggerbks: folds 
dantho: folds 
gigoulu joins the table at seat #5 
Hero: calls $0.05
Postman15: checks 
Hero: discards 3 cards [7c 3s 4d]
Dealt to Hero [Td Tc] [Js Qc 6c]
Postman15: discards 3 cards
Hero: checks 
Postman15: checks 
*** SHOW DOWN ***
Hero: shows [Td Js Qc Tc 6c] (a pair of Tens)
Postman15: shows [7s 9s Kc Qs Qh] (a pair of Queens)
Postman15 collected $0.19 from pot
*** SUMMARY ***
Total pot $0.20 | Rake $0.01 
Seat 1: triggerbks folded before the Draw (didn't bet)
Seat 3: dantho (button) folded before the Draw (didn't bet)
Seat 4: Hero (small blind) showed [Td Js Qc Tc 6c] and lost with a pair of Tens
Seat 6: Postman15 (big blind) showed [7s 9s Kc Qs Qh] and won ($0.19) with a pair of Queens



PokerStars Game #35839465638:  5 Card Draw Limit ($0.10/$0.20 USD) - 2009/11/25 14:23:06 ET
Table 'Laodica IV' 6-max Seat #4 is the button
Seat 1: triggerbks ($3.55 in chips) 
Seat 3: dantho ($3.82 in chips) 
Seat 4: Hero ($2.17 in chips) 
Seat 6: Postman15 ($2.68 in chips) 
gigoulu will be allowed to play after the button
Postman15: posts small blind $0.05
triggerbks: posts big blind $0.10
trixr4dough: sits out 
*** DEALING HANDS ***
Dealt to Hero [Qh Js Tc Qd 9d]
dantho: calls $0.10
Hero: calls $0.10
Postman15: folds 
triggerbks: checks 
triggerbks: discards 4 cards
dantho: discards 3 cards
Hero: discards 3 cards [Js Tc 9d]
Dealt to Hero [Qh Qd] [Qc 5c 7d]
triggerbks: checks 
dantho: checks 
Hero: bets $0.20
triggerbks: folds 
dantho: folds 
Uncalled bet ($0.20) returned to Hero
Hero collected $0.34 from pot
*** SUMMARY ***
Total pot $0.35 | Rake $0.01 
Seat 1: triggerbks (big blind) folded after the Draw
Seat 3: dantho folded after the Draw
Seat 4: Hero (button) collected ($0.34)
Seat 6: Postman15 (small blind) folded before the Draw



PokerStars Game #35839492817:  5 Card Draw Limit ($0.10/$0.20 USD) - 2009/11/25 14:23:39 ET
Table 'Laodica IV' 6-max Seat #6 is the button
Seat 1: triggerbks ($3.45 in chips) 
Seat 2: trixr4dough ($3 in chips) 
Seat 3: dantho ($3.72 in chips) 
Seat 4: Hero ($2.41 in chips) 
Seat 5: gigoulu ($5.50 in chips) 
Seat 6: Postman15 ($2.63 in chips) 
triggerbks: posts small blind $0.05
trixr4dough: posts big blind $0.10
gigoulu: posts big blind $0.10
*** DEALING HANDS ***
Dealt to Hero [Kc 3d 2c Ks 4d]
dantho: folds 
Hero: calls $0.10
gigoulu: checks 
Postman15 has timed out
Postman15: folds 
Postman15 is sitting out
triggerbks: calls $0.05
trixr4dough: raises $0.10 to $0.20
Postman15 has returned
Hero: calls $0.10
gigoulu: calls $0.10
triggerbks: calls $0.10
triggerbks: discards 2 cards
trixr4dough: stands pat 
Hero: discards 3 cards [3d 2c 4d]
Dealt to Hero [Kc Ks] [7c 4c 3c]
gigoulu: discards 4 cards
triggerbks: checks 
trixr4dough: bets $0.20
Hero: folds 
gigoulu: folds 
triggerbks: folds 
Uncalled bet ($0.20) returned to trixr4dough
trixr4dough collected $0.76 from pot
trixr4dough: doesn't show hand 
*** SUMMARY ***
Total pot $0.80 | Rake $0.04 
Seat 1: triggerbks (small blind) folded after the Draw
Seat 2: trixr4dough (big blind) collected ($0.76)
Seat 3: dantho folded before the Draw (didn't bet)
Seat 4: Hero folded after the Draw
Seat 5: gigoulu folded after the Draw
Seat 6: Postman15 (button) folded before the Draw (didn't bet)



PokerStars Game #35839543544:  5 Card Draw Limit ($0.10/$0.20 USD) - 2009/11/25 14:24:43 ET
Table 'Laodica IV' 6-max Seat #1 is the button
Seat 1: triggerbks ($3.25 in chips) 
Seat 2: trixr4dough ($3.56 in chips) 
Seat 3: dantho ($3.72 in chips) 
Seat 4: Hero ($2.21 in chips) 
Seat 5: gigoulu ($5.30 in chips) 
Seat 6: Postman15 ($2.63 in chips) 
trixr4dough: posts small blind $0.05
dantho: posts big blind $0.10
*** DEALING HANDS ***
Dealt to Hero [7h Js 9c Qc Ah]
Hero: folds 
gigoulu: calls $0.10
Postman15: folds 
triggerbks: folds 
trixr4dough: calls $0.05
dantho: checks 
trixr4dough: discards 2 cards
dantho: discards 3 cards
gigoulu: discards 1 card
trixr4dough: checks 
dantho: checks 
gigoulu: bets $0.20
trixr4dough: folds 
dantho: folds 
Uncalled bet ($0.20) returned to gigoulu
gigoulu collected $0.29 from pot
*** SUMMARY ***
Total pot $0.30 | Rake $0.01 
Seat 1: triggerbks (button) folded before the Draw (didn't bet)
Seat 2: trixr4dough (small blind) folded after the Draw
Seat 3: dantho (big blind) folded after the Draw
Seat 4: Hero folded before the Draw (didn't bet)
Seat 5: gigoulu collected ($0.29)
Seat 6: Postman15 folded before the Draw (didn't bet)



PokerStars Game #35839570537:  5 Card Draw Limit ($0.10/$0.20 USD) - 2009/11/25 14:25:19 ET
Table 'Laodica IV' 6-max Seat #2 is the button
Seat 1: triggerbks ($3.25 in chips) 
Seat 2: trixr4dough ($3.46 in chips) 
Seat 3: dantho ($3.62 in chips) 
Seat 4: Hero ($2.21 in chips) 
Seat 5: gigoulu ($5.49 in chips) 
Seat 6: Postman15 ($2.63 in chips) 
dantho: posts small blind $0.05
Hero: posts big blind $0.10
*** DEALING HANDS ***
Dealt to Hero [Th Ah Kd Td Js]
gigoulu: calls $0.10
Postman15: folds 
triggerbks: calls $0.10
trixr4dough: calls $0.10
dantho: calls $0.05
Hero: checks 
dantho: discards 1 card
Hero: discards 2 cards [Kd Js]
Dealt to Hero [Th Ah Td] [2c 6c]
gigoulu: discards 3 cards
triggerbks: discards 3 cards
trixr4dough: discards 3 cards
dantho: checks 
Hero: checks 
gigoulu: bets $0.20
triggerbks: folds 
trixr4dough: folds 
dantho: folds 
Hero: folds 
Uncalled bet ($0.20) returned to gigoulu
gigoulu collected $0.48 from pot
*** SUMMARY ***
Total pot $0.50 | Rake $0.02 
Seat 1: triggerbks folded after the Draw
Seat 2: trixr4dough (button) folded after the Draw
Seat 3: dantho (small blind) folded after the Draw
Seat 4: Hero (big blind) folded after the Draw
Seat 5: gigoulu collected ($0.48)
Seat 6: Postman15 folded before the Draw (didn't bet)



PokerStars Game #35839605634:  5 Card Draw Limit ($0.10/$0.20 USD) - 2009/11/25 14:26:03 ET
Table 'Laodica IV' 6-max Seat #3 is the button
Seat 1: triggerbks ($3.15 in chips) 
Seat 2: trixr4dough ($3.36 in chips) 
Seat 3: dantho ($3.52 in chips) 
Seat 4: Hero ($2.11 in chips) 
Seat 5: gigoulu ($5.87 in chips) 
Seat 6: Postman15 ($2.63 in chips) 
Hero: posts small blind $0.05
gigoulu: posts big blind $0.10
*** DEALING HANDS ***
Dealt to Hero [8c 4h Td 9s 8s]
Postman15: calls $0.10
triggerbks: folds 
trixr4dough: calls $0.10
triggerbks leaves the table
dantho: calls $0.10
Hero: folds 
gigoulu: checks 
gigoulu: discards 1 card
Postman15: discards 3 cards
trixr4dough: discards 3 cards
dantho: discards 1 card
gigoulu: bets $0.20
Postman15: calls $0.20
trixr4dough: folds 
dantho: folds 
*** SHOW DOWN ***
gigoulu: shows [Th Kd 7c Tc 7s] (two pair, Tens and Sevens)
Postman15: shows [Qh 6d 4d 6s Qd] (two pair, Queens and Sixes)
Postman15 collected $0.81 from pot
*** SUMMARY ***
Total pot $0.85 | Rake $0.04 
Seat 1: triggerbks folded before the Draw (didn't bet)
Seat 2: trixr4dough folded after the Draw
Seat 3: dantho (button) folded after the Draw
Seat 4: Hero (small blind) folded before the Draw
Seat 5: gigoulu (big blind) showed [Th Kd 7c Tc 7s] and lost with two pair, Tens and Sevens
Seat 6: Postman15 showed [Qh 6d 4d 6s Qd] and won ($0.81) with two pair, Queens and Sixes



PokerStars Game #35839634910:  5 Card Draw Limit ($0.10/$0.20 USD) - 2009/11/25 14:26:40 ET
Table 'Laodica IV' 6-max Seat #4 is the button
Seat 2: trixr4dough ($3.26 in chips) 
Seat 3: dantho ($3.42 in chips) 
Seat 4: Hero ($2.06 in chips) 
Seat 5: gigoulu ($5.57 in chips) 
Seat 6: Postman15 ($3.14 in chips) 
gigoulu: posts small blind $0.05
Postman15: posts big blind $0.10
*** DEALING HANDS ***
Dealt to Hero [8d 3d Kd 2h Js]
trixr4dough: raises $0.10 to $0.20
dantho: folds 
Hero: folds 
gigoulu: calls $0.15
Postman15: folds 
gigoulu: discards 3 cards
trixr4dough: discards 3 cards
gigoulu: checks 
trixr4dough: bets $0.20
gigoulu: calls $0.20
*** SHOW DOWN ***
trixr4dough: shows [Jd Ks Jc Kc Kh] (a full house, Kings full of Jacks)
gigoulu: mucks hand 
trixr4dough collected $0.86 from pot
*** SUMMARY ***
Total pot $0.90 | Rake $0.04 
Seat 2: trixr4dough showed [Jd Ks Jc Kc Kh] and won ($0.86) with a full house, Kings full of Jacks
Seat 3: dantho folded before the Draw (didn't bet)
Seat 4: Hero (button) folded before the Draw (didn't bet)
Seat 5: gigoulu (small blind) mucked [Qc 5d Qs 8c Th]
Seat 6: Postman15 (big blind) folded before the Draw



PokerStars Game #35839661301:  5 Card Draw Limit ($0.10/$0.20 USD) - 2009/11/25 14:27:13 ET
Table 'Laodica IV' 6-max Seat #5 is the button
Seat 2: trixr4dough ($3.72 in chips) 
Seat 3: dantho ($3.42 in chips) 
Seat 4: Hero ($2.06 in chips) 
Seat 5: gigoulu ($5.17 in chips) 
Seat 6: Postman15 ($3.04 in chips) 
Postman15: posts small blind $0.05
trixr4dough: posts big blind $0.10
*** DEALING HANDS ***
Dealt to Hero [Th 5d Js Jd Kd]
dantho: calls $0.10
Hero: raises $0.10 to $0.20
gigoulu: folds 
Postman15: calls $0.15
trixr4dough: calls $0.10
dantho: calls $0.10
Postman15: discards 1 card
trixr4dough: discards 1 card
dantho: discards 3 cards
Hero: discards 2 cards [Th 5d]
Dealt to Hero [Js Jd Kd] [Ac 3h]
Postman15: checks 
trixr4dough: checks 
dantho: checks 
Hero: checks 
*** SHOW DOWN ***
Postman15: shows [8d 8s 7c 8h Ah] (three of a kind, Eights)
trixr4dough: mucks hand 
dantho: mucks hand 
Hero: mucks hand 
Postman15 collected $0.76 from pot
*** SUMMARY ***
Total pot $0.80 | Rake $0.04 
Seat 2: trixr4dough (big blind) mucked [6s 7h 4d 3c 9c]
Seat 3: dantho mucked [Qh Qd 4s 6h Tc]
Seat 4: Hero mucked [Ac 3h Js Jd Kd]
Seat 5: gigoulu (button) folded before the Draw (didn't bet)
Seat 6: Postman15 (small blind) showed [8d 8s 7c 8h Ah] and won ($0.76) with three of a kind, Eights



PokerStars Game #35839693667:  5 Card Draw Limit ($0.10/$0.20 USD) - 2009/11/25 14:27:55 ET
Table 'Laodica IV' 6-max Seat #6 is the button
Seat 2: trixr4dough ($3.52 in chips) 
Seat 4: Hero ($1.86 in chips) 
Seat 5: gigoulu ($5.17 in chips) 
Seat 6: Postman15 ($3.60 in chips) 
trixr4dough: posts small blind $0.05
dantho: is sitting out 
Hero: posts big blind $0.10
*** DEALING HANDS ***
Dealt to Hero [8s 2h Jh 4d Ac]
dantho leaves the table
gigoulu: calls $0.10
Postman15: folds 
trixr4dough: calls $0.05
Hero: checks 
trixr4dough: discards 4 cards
Hero: discards 4 cards [8s 2h Jh 4d]
Dealt to Hero [Ac] [6c Qh 8h 9d]
gigoulu: discards 1 card
trixr4dough: checks 
Hero: checks 
gigoulu: bets $0.20
KAAGEE joins the table at seat #1 
trixr4dough: folds 
Hero: folds 
Uncalled bet ($0.20) returned to gigoulu
gigoulu collected $0.29 from pot
*** SUMMARY ***
Total pot $0.30 | Rake $0.01 
Seat 2: trixr4dough (small blind) folded after the Draw
Seat 4: Hero (big blind) folded after the Draw
Seat 5: gigoulu collected ($0.29)
Seat 6: Postman15 (button) folded before the Draw (didn't bet)



