PokerStars Game #35602019775:  Hold'em No Limit (€0.05/€0.10 EUR) - 2009/11/20 7:12:10 ET
Table 'Lampland' 6-max Seat #2 is the button
Seat 1: rico4429 (€2.37 in chips) 
Seat 2: HomerrrJay (€10 in chips) 
Seat 3: joycer01 (€4.60 in chips) 
Seat 4: Hero (€2 in chips) 
Seat 5: Poptart74 (€2.34 in chips) 
Seat 6: PokerMill100 (€7.60 in chips) 
joycer01: posts small blind €0.05
Hero: posts big blind €0.10
rico4429: posts big blind €0.10
*** HOLE CARDS ***
Dealt to Hero [Js 3d]
Poptart74: folds 
PokerMill100: calls €0.10
rico4429: checks 
HomerrrJay: folds 
joycer01: calls €0.05
Hero: checks 
*** FLOP *** [8h Jh Kh]
joycer01: checks 
Hero: checks 
PokerMill100: checks 
rico4429: checks 
*** TURN *** [8h Jh Kh] [Ah]
joycer01: checks 
Hero: checks 
PokerMill100: checks 
rico4429: bets €0.50
joycer01: folds 
Hero: folds 
PokerMill100: folds 
Uncalled bet (€0.50) returned to rico4429
rico4429 collected €0.38 from pot
rico4429: doesn't show hand 
*** SUMMARY ***
Total pot €0.40 | Rake €0.02 
Board [8h Jh Kh Ah]
Seat 1: rico4429 collected (€0.38)
Seat 2: HomerrrJay (button) folded before Flop (didn't bet)
Seat 3: joycer01 (small blind) folded on the Turn
Seat 4: Hero (big blind) folded on the Turn
Seat 5: Poptart74 folded before Flop (didn't bet)
Seat 6: PokerMill100 folded on the Turn



PokerStars Game #35602035916:  Hold'em No Limit (€0.05/€0.10 EUR) - 2009/11/20 7:12:55 ET
Table 'Lampland' 6-max Seat #3 is the button
Seat 1: rico4429 (€2.65 in chips) 
Seat 2: HomerrrJay (€10 in chips) 
Seat 3: joycer01 (€4.50 in chips) 
Seat 4: Hero (€1.90 in chips) 
Seat 5: Poptart74 (€2.34 in chips) 
Seat 6: PokerMill100 (€7.50 in chips) 
Hero: posts small blind €0.05
Poptart74: posts big blind €0.10
*** HOLE CARDS ***
Dealt to Hero [Th Td]
PokerMill100: raises €0.20 to €0.30
rico4429: folds 
HomerrrJay: folds 
joycer01: calls €0.30
Hero: raises €1.60 to €1.90 and is all-in
Poptart74: folds 
PokerMill100: folds 
joycer01: folds 
Uncalled bet (€1.60) returned to Hero
Hero collected €1 from pot
*** SUMMARY ***
Total pot €1 | Rake €0 
Seat 1: rico4429 folded before Flop (didn't bet)
Seat 2: HomerrrJay folded before Flop (didn't bet)
Seat 3: joycer01 (button) folded before Flop
Seat 4: Hero (small blind) collected (€1)
Seat 5: Poptart74 (big blind) folded before Flop
Seat 6: PokerMill100 folded before Flop



PokerStars Game #35602045689:  Hold'em No Limit (€0.05/€0.10 EUR) - 2009/11/20 7:13:22 ET
Table 'Lampland' 6-max Seat #4 is the button
Seat 1: rico4429 (€2.65 in chips) 
Seat 2: HomerrrJay (€10 in chips) 
Seat 3: joycer01 (€4.20 in chips) 
Seat 4: Hero (€2.60 in chips) 
Seat 5: Poptart74 (€2.24 in chips) 
Seat 6: PokerMill100 (€7.20 in chips) 
Poptart74: posts small blind €0.05
PokerMill100: posts big blind €0.10
*** HOLE CARDS ***
Dealt to Hero [Qh Js]
rico4429: calls €0.10
HomerrrJay: folds 
joycer01: folds 
Hero: calls €0.10
Poptart74: calls €0.05
PokerMill100: checks 
*** FLOP *** [7s 3c 7h]
Poptart74: checks 
PokerMill100: checks 
rico4429: checks 
Hero: checks 
*** TURN *** [7s 3c 7h] [2c]
Poptart74: checks 
PokerMill100: checks 
rico4429: bets €0.40
Hero: folds 
Poptart74: folds 
PokerMill100: folds 
Uncalled bet (€0.40) returned to rico4429
rico4429 collected €0.38 from pot
rico4429: doesn't show hand 
*** SUMMARY ***
Total pot €0.40 | Rake €0.02 
Board [7s 3c 7h 2c]
Seat 1: rico4429 collected (€0.38)
Seat 2: HomerrrJay folded before Flop (didn't bet)
Seat 3: joycer01 folded before Flop (didn't bet)
Seat 4: Hero (button) folded on the Turn
Seat 5: Poptart74 (small blind) folded on the Turn
Seat 6: PokerMill100 (big blind) folded on the Turn



PokerStars Game #35602058746:  Hold'em No Limit (€0.05/€0.10 EUR) - 2009/11/20 7:13:58 ET
Table 'Lampland' 6-max Seat #5 is the button
Seat 1: rico4429 (€2.93 in chips) 
Seat 2: HomerrrJay (€10 in chips) 
Seat 3: joycer01 (€4.20 in chips) 
Seat 4: Hero (€2.50 in chips) 
Seat 5: Poptart74 (€2.14 in chips) 
Seat 6: PokerMill100 (€7.10 in chips) 
PokerMill100: posts small blind €0.05
rico4429: posts big blind €0.10
*** HOLE CARDS ***
Dealt to Hero [Kh 8h]
HomerrrJay: folds 
joycer01: calls €0.10
Hero: raises €0.30 to €0.40
Poptart74: calls €0.40
PokerMill100: folds 
rico4429: calls €0.30
joycer01: calls €0.30
*** FLOP *** [2d Ad 6d]
rico4429: checks 
joycer01: bets €0.60
Hero: folds 
Poptart74: calls €0.60
rico4429: calls €0.60
*** TURN *** [2d Ad 6d] [9s]
rico4429: checks 
joycer01: bets €3.20 and is all-in
Poptart74: calls €1.14 and is all-in
rico4429: folds 
Uncalled bet (€2.06) returned to joycer01
*** RIVER *** [2d Ad 6d 9s] [Th]
*** SHOW DOWN ***
joycer01: shows [Qd 8c] (high card Ace)
Poptart74: shows [6s As] (two pair, Aces and Sixes)
Poptart74 collected €5.46 from pot
*** SUMMARY ***
Total pot €5.73 | Rake €0.27 
Board [2d Ad 6d 9s Th]
Seat 1: rico4429 (big blind) folded on the Turn
Seat 2: HomerrrJay folded before Flop (didn't bet)
Seat 3: joycer01 showed [Qd 8c] and lost with high card Ace
Seat 4: Hero folded on the Flop
Seat 5: Poptart74 (button) showed [6s As] and won (€5.46) with two pair, Aces and Sixes
Seat 6: PokerMill100 (small blind) folded before Flop



PokerStars Game #35602079546:  Hold'em No Limit (€0.05/€0.10 EUR) - 2009/11/20 7:14:56 ET
Table 'Lampland' 6-max Seat #6 is the button
Seat 1: rico4429 (€1.93 in chips) 
Seat 2: HomerrrJay (€10 in chips) 
Seat 3: joycer01 (€2.06 in chips) 
Seat 4: Hero (€2.10 in chips) 
Seat 5: Poptart74 (€5.46 in chips) 
Seat 6: PokerMill100 (€7.05 in chips) 
rico4429: posts small blind €0.05
HomerrrJay: posts big blind €0.10
*** HOLE CARDS ***
Dealt to Hero [5s 2h]
joycer01: folds 
Hero: folds 
Poptart74: calls €0.10
PokerMill100: calls €0.10
rico4429: calls €0.05
HomerrrJay: checks 
*** FLOP *** [Jc 9s Qd]
rico4429: checks 
HomerrrJay: checks 
Poptart74: bets €0.20
PokerMill100: raises €0.30 to €0.50
rico4429: folds 
HomerrrJay: folds 
Poptart74: calls €0.30
*** TURN *** [Jc 9s Qd] [6c]
Poptart74: checks 
PokerMill100: bets €0.70
Poptart74: calls €0.70
*** RIVER *** [Jc 9s Qd 6c] [4h]
Poptart74: checks 
PokerMill100: bets €1.20
Poptart74: calls €1.20
*** SHOW DOWN ***
PokerMill100: shows [Td 8s] (a straight, Eight to Queen)
Poptart74: mucks hand 
PokerMill100 collected €4.95 from pot
*** SUMMARY ***
Total pot €5.20 | Rake €0.25 
Board [Jc 9s Qd 6c 4h]
Seat 1: rico4429 (small blind) folded on the Flop
Seat 2: HomerrrJay (big blind) folded on the Flop
Seat 3: joycer01 folded before Flop (didn't bet)
Seat 4: Hero folded before Flop (didn't bet)
Seat 5: Poptart74 mucked [9c Qh]
Seat 6: PokerMill100 (button) showed [Td 8s] and won (€4.95) with a straight, Eight to Queen



PokerStars Game #35602095789:  Hold'em No Limit (€0.05/€0.10 EUR) - 2009/11/20 7:15:42 ET
Table 'Lampland' 6-max Seat #1 is the button
Seat 1: rico4429 (€1.83 in chips) 
Seat 2: HomerrrJay (€10 in chips) 
Seat 3: joycer01 (€2.06 in chips) 
Seat 4: Hero (€2.10 in chips) 
Seat 5: Poptart74 (€2.96 in chips) 
Seat 6: PokerMill100 (€9.50 in chips) 
HomerrrJay: posts small blind €0.05
joycer01: posts big blind €0.10
*** HOLE CARDS ***
Dealt to Hero [2c Jc]
Hero: folds 
Poptart74: calls €0.10
PokerMill100: raises €0.30 to €0.40
rico4429: folds 
HomerrrJay: folds 
joycer01: folds 
Poptart74: calls €0.30
*** FLOP *** [Kc 9s Qs]
Poptart74: checks 
PokerMill100: checks 
*** TURN *** [Kc 9s Qs] [Ts]
Poptart74: checks 
PokerMill100: bets €0.50
Poptart74: folds 
Uncalled bet (€0.50) returned to PokerMill100
PokerMill100 collected €0.91 from pot
*** SUMMARY ***
Total pot €0.95 | Rake €0.04 
Board [Kc 9s Qs Ts]
Seat 1: rico4429 (button) folded before Flop (didn't bet)
Seat 2: HomerrrJay (small blind) folded before Flop
Seat 3: joycer01 (big blind) folded before Flop
Seat 4: Hero folded before Flop (didn't bet)
Seat 5: Poptart74 folded on the Turn
Seat 6: PokerMill100 collected (€0.91)



PokerStars Game #35602107646:  Hold'em No Limit (€0.05/€0.10 EUR) - 2009/11/20 7:16:15 ET
Table 'Lampland' 6-max Seat #2 is the button
Seat 1: rico4429 (€1.83 in chips) 
Seat 2: HomerrrJay (€10 in chips) 
Seat 3: joycer01 (€1.96 in chips) 
Seat 4: Hero (€2.10 in chips) 
Seat 5: Poptart74 (€2.56 in chips) 
Seat 6: PokerMill100 (€10.01 in chips) 
joycer01: posts small blind €0.05
Hero: posts big blind €0.10
*** HOLE CARDS ***
Dealt to Hero [3c 6s]
Poptart74: folds 
PokerMill100: calls €0.10
rico4429: calls €0.10
HomerrrJay: folds 
joycer01: calls €0.05
Hero: checks 
*** FLOP *** [Kd Qh 6c]
joycer01: checks 
Hero: checks 
PokerMill100: checks 
rico4429: bets €0.60
joycer01: folds 
Hero: folds 
PokerMill100: folds 
Uncalled bet (€0.60) returned to rico4429
rico4429 collected €0.38 from pot
*** SUMMARY ***
Total pot €0.40 | Rake €0.02 
Board [Kd Qh 6c]
Seat 1: rico4429 collected (€0.38)
Seat 2: HomerrrJay (button) folded before Flop (didn't bet)
Seat 3: joycer01 (small blind) folded on the Flop
Seat 4: Hero (big blind) folded on the Flop
Seat 5: Poptart74 folded before Flop (didn't bet)
Seat 6: PokerMill100 folded on the Flop



PokerStars Game #35602118812:  Hold'em No Limit (€0.05/€0.10 EUR) - 2009/11/20 7:16:47 ET
Table 'Lampland' 6-max Seat #3 is the button
Seat 1: rico4429 (€2.11 in chips) 
Seat 2: HomerrrJay (€10 in chips) 
Seat 3: joycer01 (€1.86 in chips) 
Seat 4: Hero (€2 in chips) 
Seat 5: Poptart74 (€2.56 in chips) 
Seat 6: PokerMill100 (€9.91 in chips) 
Hero: posts small blind €0.05
Poptart74: posts big blind €0.10
*** HOLE CARDS ***
Dealt to Hero [2d Ts]
PokerMill100: folds 
rico4429: calls €0.10
HomerrrJay: folds 
joycer01: raises €0.30 to €0.40
Hero: folds 
Poptart74: folds 
rico4429: calls €0.30
*** FLOP *** [Jc 8d Ah]
rico4429: checks 
joycer01: bets €0.60
rico4429: folds 
Uncalled bet (€0.60) returned to joycer01
joycer01 collected €0.91 from pot
*** SUMMARY ***
Total pot €0.95 | Rake €0.04 
Board [Jc 8d Ah]
Seat 1: rico4429 folded on the Flop
Seat 2: HomerrrJay folded before Flop (didn't bet)
Seat 3: joycer01 (button) collected (€0.91)
Seat 4: Hero (small blind) folded before Flop
Seat 5: Poptart74 (big blind) folded before Flop
Seat 6: PokerMill100 folded before Flop (didn't bet)



PokerStars Game #35602127914:  Hold'em No Limit (€0.05/€0.10 EUR) - 2009/11/20 7:17:12 ET
Table 'Lampland' 6-max Seat #4 is the button
Seat 1: rico4429 (€1.71 in chips) 
Seat 2: HomerrrJay (€10 in chips) 
Seat 3: joycer01 (€2.37 in chips) 
Seat 4: Hero (€1.95 in chips) 
Seat 5: Poptart74 (€2.46 in chips) 
Seat 6: PokerMill100 (€9.91 in chips) 
Poptart74: posts small blind €0.05
PokerMill100: posts big blind €0.10
*** HOLE CARDS ***
Dealt to Hero [2c 8h]
rico4429: raises €0.10 to €0.20
HomerrrJay: folds 
joycer01: folds 
Hero: folds 
Poptart74: calls €0.15
PokerMill100: calls €0.10
*** FLOP *** [7c 3c 2d]
Poptart74: bets €0.20
PokerMill100: folds 
rico4429: raises €1.31 to €1.51 and is all-in
Poptart74: calls €1.31
*** TURN *** [7c 3c 2d] [7s]
*** RIVER *** [7c 3c 2d 7s] [5h]
*** SHOW DOWN ***
Poptart74: shows [Th Td] (two pair, Tens and Sevens)
rico4429: shows [Ad Js] (a pair of Sevens)
Poptart74 collected €3.45 from pot
*** SUMMARY ***
Total pot €3.62 | Rake €0.17 
Board [7c 3c 2d 7s 5h]
Seat 1: rico4429 showed [Ad Js] and lost with a pair of Sevens
Seat 2: HomerrrJay folded before Flop (didn't bet)
Seat 3: joycer01 folded before Flop (didn't bet)
Seat 4: Hero (button) folded before Flop (didn't bet)
Seat 5: Poptart74 (small blind) showed [Th Td] and won (€3.45) with two pair, Tens and Sevens
Seat 6: PokerMill100 (big blind) folded on the Flop



PokerStars Game #35602140774:  Hold'em No Limit (€0.05/€0.10 EUR) - 2009/11/20 7:17:48 ET
Table 'Lampland' 6-max Seat #5 is the button
Seat 2: HomerrrJay (€10 in chips) 
Seat 3: joycer01 (€2.37 in chips) 
Seat 4: Hero (€1.95 in chips) 
Seat 5: Poptart74 (€4.20 in chips) 
Seat 6: PokerMill100 (€9.71 in chips) 
PokerMill100: posts small blind €0.05
HomerrrJay: posts big blind €0.10
*** HOLE CARDS ***
Dealt to Hero [7h Jh]
joycer01: raises €0.30 to €0.40
Hero: folds 
rico4429 leaves the table
Poptart74: folds 
PokerMill100: folds 
HomerrrJay: folds 
Uncalled bet (€0.30) returned to joycer01
joycer01 collected €0.25 from pot
*** SUMMARY ***
Total pot €0.25 | Rake €0 
Seat 2: HomerrrJay (big blind) folded before Flop
Seat 3: joycer01 collected (€0.25)
Seat 4: Hero folded before Flop (didn't bet)
Seat 5: Poptart74 (button) folded before Flop (didn't bet)
Seat 6: PokerMill100 (small blind) folded before Flop



PokerStars Game #35602147145:  Hold'em No Limit (€0.05/€0.10 EUR) - 2009/11/20 7:18:07 ET
Table 'Lampland' 6-max Seat #6 is the button
Seat 2: HomerrrJay (€10 in chips) 
Seat 3: joycer01 (€2.52 in chips) 
Seat 4: Hero (€1.95 in chips) 
Seat 5: Poptart74 (€4.20 in chips) 
Seat 6: PokerMill100 (€9.66 in chips) 
HomerrrJay: posts small blind €0.05
joycer01: posts big blind €0.10
*** HOLE CARDS ***
Dealt to Hero [9h 2d]
Oswood joins the table at seat #1 
Hero: folds 
Poptart74: calls €0.10
PokerMill100: folds 
HomerrrJay: folds 
joycer01: checks 
*** FLOP *** [6h 5c 4s]
joycer01: bets €0.30
Poptart74: folds 
Uncalled bet (€0.30) returned to joycer01
joycer01 collected €0.24 from pot
*** SUMMARY ***
Total pot €0.25 | Rake €0.01 
Board [6h 5c 4s]
Seat 2: HomerrrJay (small blind) folded before Flop
Seat 3: joycer01 (big blind) collected (€0.24)
Seat 4: Hero folded before Flop (didn't bet)
Seat 5: Poptart74 folded on the Flop
Seat 6: PokerMill100 (button) folded before Flop (didn't bet)



PokerStars Game #35602157098:  Hold'em No Limit (€0.05/€0.10 EUR) - 2009/11/20 7:18:35 ET
Table 'Lampland' 6-max Seat #2 is the button
Seat 1: Oswood (€10 in chips) 
Seat 2: HomerrrJay (€10 in chips) 
Seat 3: joycer01 (€2.66 in chips) 
Seat 4: Hero (€1.95 in chips) 
Seat 5: Poptart74 (€4.10 in chips) 
Seat 6: PokerMill100 (€9.66 in chips) 
joycer01: posts small blind €0.05
Hero: posts big blind €0.10
Oswood: posts big blind €0.10
*** HOLE CARDS ***
Dealt to Hero [2h 8d]
Poptart74: calls €0.10
PokerMill100: raises €0.20 to €0.30
Oswood: calls €0.20
HomerrrJay: folds 
joycer01: folds 
Hero: folds 
Poptart74: calls €0.20
*** FLOP *** [4h Ac 7h]
Poptart74: checks 
PokerMill100: bets €0.50
Oswood: folds 
Poptart74: folds 
Uncalled bet (€0.50) returned to PokerMill100
PokerMill100 collected €1 from pot
*** SUMMARY ***
Total pot €1.05 | Rake €0.05 
Board [4h Ac 7h]
Seat 1: Oswood folded on the Flop
Seat 2: HomerrrJay (button) folded before Flop (didn't bet)
Seat 3: joycer01 (small blind) folded before Flop
Seat 4: Hero (big blind) folded before Flop
Seat 5: Poptart74 folded on the Flop
Seat 6: PokerMill100 collected (€1)



PokerStars Game #35602167705:  Hold'em No Limit (€0.05/€0.10 EUR) - 2009/11/20 7:19:05 ET
Table 'Lampland' 6-max Seat #3 is the button
Seat 1: Oswood (€9.70 in chips) 
Seat 2: HomerrrJay (€10 in chips) 
Seat 3: joycer01 (€2.61 in chips) 
Seat 4: Hero (€1.85 in chips) 
Seat 5: Poptart74 (€3.80 in chips) 
Seat 6: PokerMill100 (€10.36 in chips) 
Hero: posts small blind €0.05
Poptart74: posts big blind €0.10
*** HOLE CARDS ***
Dealt to Hero [Qh 9d]
PokerMill100: folds 
Oswood: folds 
HomerrrJay: folds 
joycer01: folds 
Hero: raises €0.20 to €0.30
Poptart74: calls €0.20
*** FLOP *** [6c Ks Td]
Hero: checks 
Poptart74: checks 
*** TURN *** [6c Ks Td] [Qs]
Hero: bets €0.50
Poptart74: folds 
Uncalled bet (€0.50) returned to Hero
Hero collected €0.57 from pot
*** SUMMARY ***
Total pot €0.60 | Rake €0.03 
Board [6c Ks Td Qs]
Seat 1: Oswood folded before Flop (didn't bet)
Seat 2: HomerrrJay folded before Flop (didn't bet)
Seat 3: joycer01 (button) folded before Flop (didn't bet)
Seat 4: Hero (small blind) collected (€0.57)
Seat 5: Poptart74 (big blind) folded on the Turn
Seat 6: PokerMill100 folded before Flop (didn't bet)



PokerStars Game #35602182667:  Hold'em No Limit (€0.05/€0.10 EUR) - 2009/11/20 7:19:47 ET
Table 'Lampland' 6-max Seat #4 is the button
Seat 1: Oswood (€9.70 in chips) 
Seat 2: HomerrrJay (€10 in chips) 
Seat 3: joycer01 (€2.61 in chips) 
Seat 4: Hero (€2.12 in chips) 
Seat 5: Poptart74 (€3.50 in chips) 
Seat 6: PokerMill100 (€10.36 in chips) 
Poptart74: posts small blind €0.05
PokerMill100: posts big blind €0.10
*** HOLE CARDS ***
Dealt to Hero [Ad 4c]
Oswood: folds 
HomerrrJay: raises €0.20 to €0.30
joycer01: calls €0.30
Hero: folds 
Poptart74: folds 
PokerMill100: folds 
*** FLOP *** [Tc 6d 4d]
HomerrrJay: bets €0.40
joycer01: folds 
Uncalled bet (€0.40) returned to HomerrrJay
HomerrrJay collected €0.72 from pot
HomerrrJay: doesn't show hand 
*** SUMMARY ***
Total pot €0.75 | Rake €0.03 
Board [Tc 6d 4d]
Seat 1: Oswood folded before Flop (didn't bet)
Seat 2: HomerrrJay collected (€0.72)
Seat 3: joycer01 folded on the Flop
Seat 4: Hero (button) folded before Flop (didn't bet)
Seat 5: Poptart74 (small blind) folded before Flop
Seat 6: PokerMill100 (big blind) folded before Flop



PokerStars Game #35602198225:  Hold'em No Limit (€0.05/€0.10 EUR) - 2009/11/20 7:20:27 ET
Table 'Lampland' 6-max Seat #5 is the button
Seat 1: Oswood (€9.70 in chips) 
Seat 2: HomerrrJay (€10.42 in chips) 
Seat 3: joycer01 (€2.31 in chips) 
Seat 4: Hero (€2.12 in chips) 
Seat 5: Poptart74 (€3.45 in chips) 
Seat 6: PokerMill100 (€10.26 in chips) 
PokerMill100: posts small blind €0.05
Oswood: posts big blind €0.10
*** HOLE CARDS ***
Dealt to Hero [Td 7d]
HomerrrJay: folds 
joycer01: raises €0.20 to €0.30
Hero: folds 
Poptart74: folds 
PokerMill100: folds 
Oswood: folds 
Uncalled bet (€0.20) returned to joycer01
joycer01 collected €0.25 from pot
*** SUMMARY ***
Total pot €0.25 | Rake €0 
Seat 1: Oswood (big blind) folded before Flop
Seat 2: HomerrrJay folded before Flop (didn't bet)
Seat 3: joycer01 collected (€0.25)
Seat 4: Hero folded before Flop (didn't bet)
Seat 5: Poptart74 (button) folded before Flop (didn't bet)
Seat 6: PokerMill100 (small blind) folded before Flop



PokerStars Game #35602204974:  Hold'em No Limit (€0.05/€0.10 EUR) - 2009/11/20 7:20:46 ET
Table 'Lampland' 6-max Seat #6 is the button
Seat 1: Oswood (€9.60 in chips) 
Seat 2: HomerrrJay (€10.42 in chips) 
Seat 3: joycer01 (€2.46 in chips) 
Seat 4: Hero (€2.12 in chips) 
Seat 5: Poptart74 (€3.45 in chips) 
Seat 6: PokerMill100 (€10.21 in chips) 
Oswood: posts small blind €0.05
HomerrrJay: posts big blind €0.10
*** HOLE CARDS ***
Dealt to Hero [6c 4s]
joycer01: raises €0.30 to €0.40
Hero: folds 
Poptart74: folds 
PokerMill100: calls €0.40
Oswood: calls €0.35
HomerrrJay: folds 
*** FLOP *** [3s 6h Qs]
Oswood: checks 
joycer01: bets €0.60
PokerMill100: calls €0.60
Oswood: raises €0.80 to €1.40
joycer01: raises €0.66 to €2.06 and is all-in
PokerMill100: folds 
Oswood: calls €0.66
*** TURN *** [3s 6h Qs] [2h]
*** RIVER *** [3s 6h Qs 2h] [5h]
*** SHOW DOWN ***
Oswood: shows [Qh Ah] (a flush, Ace high)
joycer01: shows [Ks Qd] (a pair of Queens)
Oswood collected €5.73 from pot
*** SUMMARY ***
Total pot €6.02 | Rake €0.29 
Board [3s 6h Qs 2h 5h]
Seat 1: Oswood (small blind) showed [Qh Ah] and won (€5.73) with a flush, Ace high
Seat 2: HomerrrJay (big blind) folded before Flop
Seat 3: joycer01 showed [Ks Qd] and lost with a pair of Queens
Seat 4: Hero folded before Flop (didn't bet)
Seat 5: Poptart74 folded before Flop (didn't bet)
Seat 6: PokerMill100 (button) folded on the Flop



PokerStars Game #35602222776:  Hold'em No Limit (€0.05/€0.10 EUR) - 2009/11/20 7:21:34 ET
Table 'Lampland' 6-max Seat #1 is the button
Seat 1: Oswood (€12.87 in chips) 
Seat 2: HomerrrJay (€10.32 in chips) 
Seat 4: Hero (€2.12 in chips) 
Seat 5: Poptart74 (€3.45 in chips) 
Seat 6: PokerMill100 (€9.21 in chips) 
HomerrrJay: posts small blind €0.05
Hero: posts big blind €0.10
*** HOLE CARDS ***
Dealt to Hero [Ad 4h]
Poptart74: folds 
joycer01 has returned
PokerMill100: folds 
Oswood: folds 
HomerrrJay: raises €0.20 to €0.30
Hero: folds 
Uncalled bet (€0.20) returned to HomerrrJay
HomerrrJay collected €0.20 from pot
joycer01 leaves the table
HomerrrJay: doesn't show hand 
*** SUMMARY ***
Total pot €0.20 | Rake €0 
Seat 1: Oswood (button) folded before Flop (didn't bet)
Seat 2: HomerrrJay (small blind) collected (€0.20)
Seat 4: Hero (big blind) folded before Flop
Seat 5: Poptart74 folded before Flop (didn't bet)
Seat 6: PokerMill100 folded before Flop (didn't bet)



PokerStars Game #35602228303:  Hold'em No Limit (€0.05/€0.10 EUR) - 2009/11/20 7:21:49 ET
Table 'Lampland' 6-max Seat #2 is the button
Seat 1: Oswood (€12.87 in chips) 
Seat 2: HomerrrJay (€10.42 in chips) 
Seat 4: Hero (€2.02 in chips) 
Seat 5: Poptart74 (€3.45 in chips) 
Seat 6: PokerMill100 (€9.21 in chips) 
Hero: posts small blind €0.05
Poptart74: posts big blind €0.10
*** HOLE CARDS ***
Dealt to Hero [5s Ad]
PokerMill100: folds 
Oswood: folds 
HomerrrJay: folds 
Hero: raises €0.20 to €0.30
Poptart74: calls €0.20
*** FLOP *** [6c 3d 5h]
Hero: bets €0.40
Poptart74: calls €0.40
*** TURN *** [6c 3d 5h] [Qc]
Hero: checks 
Poptart74: bets €0.60
Hero: calls €0.60
*** RIVER *** [6c 3d 5h Qc] [6h]
andi661 joins the table at seat #3 
Hero: bets €0.72 and is all-in
Poptart74: folds 
Uncalled bet (€0.72) returned to Hero
Hero collected €2.48 from pot
*** SUMMARY ***
Total pot €2.60 | Rake €0.12 
Board [6c 3d 5h Qc 6h]
Seat 1: Oswood folded before Flop (didn't bet)
Seat 2: HomerrrJay (button) folded before Flop (didn't bet)
Seat 4: Hero (small blind) collected (€2.48)
Seat 5: Poptart74 (big blind) folded on the River
Seat 6: PokerMill100 folded before Flop (didn't bet)



PokerStars Game #35602249531:  Hold'em No Limit (€0.05/€0.10 EUR) - 2009/11/20 7:22:44 ET
Table 'Lampland' 6-max Seat #4 is the button
Seat 1: Oswood (€12.87 in chips) 
Seat 2: HomerrrJay (€10.42 in chips) 
Seat 3: andi661 (€2.83 in chips) 
Seat 4: Hero (€3.20 in chips) 
Seat 5: Poptart74 (€2.15 in chips) 
Seat 6: PokerMill100 (€9.21 in chips) 
Poptart74: posts small blind €0.05
PokerMill100: posts big blind €0.10
andi661: posts big blind €0.10
*** HOLE CARDS ***
Dealt to Hero [Tc Td]
Oswood: folds 
HomerrrJay: raises €0.40 to €0.50
andi661: calls €0.40
Hero: raises €2.70 to €3.20 and is all-in
Poptart74: folds 
PokerMill100: folds 
HomerrrJay: raises €2.70 to €5.90
andi661: folds 
Uncalled bet (€2.70) returned to HomerrrJay
*** FLOP *** [7s Th 6h]
*** TURN *** [7s Th 6h] [6d]
*** RIVER *** [7s Th 6h 6d] [Jd]
*** SHOW DOWN ***
HomerrrJay: shows [Kd Ks] (two pair, Kings and Sixes)
Hero: shows [Tc Td] (a full house, Tens full of Sixes)
Hero collected €6.70 from pot
*** SUMMARY ***
Total pot €7.05 | Rake €0.35 
Board [7s Th 6h 6d Jd]
Seat 1: Oswood folded before Flop (didn't bet)
Seat 2: HomerrrJay showed [Kd Ks] and lost with two pair, Kings and Sixes
Seat 3: andi661 folded before Flop
Seat 4: Hero (button) showed [Tc Td] and won (€6.70) with a full house, Tens full of Sixes
Seat 5: Poptart74 (small blind) folded before Flop
Seat 6: PokerMill100 (big blind) folded before Flop



PokerStars Game #35602268793:  Hold'em No Limit (€0.05/€0.10 EUR) - 2009/11/20 7:23:36 ET
Table 'Lampland' 6-max Seat #5 is the button
Seat 1: Oswood (€12.87 in chips) 
Seat 2: HomerrrJay (€10 in chips) 
Seat 3: andi661 (€2.33 in chips) 
Seat 4: Hero (€6.70 in chips) 
Seat 5: Poptart74 (€2.10 in chips) 
Seat 6: PokerMill100 (€9.11 in chips) 
PokerMill100: posts small blind €0.05
Oswood: posts big blind €0.10
*** HOLE CARDS ***
Dealt to Hero [2d Kh]
HomerrrJay: folds 
andi661: calls €0.10
Hero: folds 
Poptart74: folds 
PokerMill100: calls €0.05
Oswood: checks 
*** FLOP *** [Kc 8s Ah]
PokerMill100: bets €0.20
Oswood: calls €0.20
andi661: folds 
*** TURN *** [Kc 8s Ah] [8d]
PokerMill100: bets €0.40
Oswood: calls €0.40
*** RIVER *** [Kc 8s Ah 8d] [Jc]
PokerMill100: checks 
Oswood: bets €0.40
PokerMill100: calls €0.40
*** SHOW DOWN ***
Oswood: shows [Tc Ac] (two pair, Aces and Eights)
PokerMill100: shows [As 7d] (two pair, Aces and Eights)
PokerMill100 collected €1.10 from pot
Oswood collected €1.09 from pot
*** SUMMARY ***
Total pot €2.30 | Rake €0.11 
Board [Kc 8s Ah 8d Jc]
Seat 1: Oswood (big blind) showed [Tc Ac] and won (€1.09) with two pair, Aces and Eights
Seat 2: HomerrrJay folded before Flop (didn't bet)
Seat 3: andi661 folded on the Flop
Seat 4: Hero folded before Flop (didn't bet)
Seat 5: Poptart74 (button) folded before Flop (didn't bet)
Seat 6: PokerMill100 (small blind) showed [As 7d] and won (€1.10) with two pair, Aces and Eights



PokerStars Game #35602280589:  Hold'em No Limit (€0.05/€0.10 EUR) - 2009/11/20 7:24:07 ET
Table 'Lampland' 6-max Seat #6 is the button
Seat 1: Oswood (€12.86 in chips) 
Seat 2: HomerrrJay (€10 in chips) 
Seat 3: andi661 (€2.23 in chips) 
Seat 4: Hero (€6.70 in chips) 
Seat 5: Poptart74 (€2.10 in chips) 
Seat 6: PokerMill100 (€9.11 in chips) 
Oswood: posts small blind €0.05
HomerrrJay: posts big blind €0.10
*** HOLE CARDS ***
Dealt to Hero [Ac 9c]
andi661: folds 
Hero: raises €0.20 to €0.30
Poptart74 is disconnected 
Poptart74 is connected 
Poptart74: folds 
PokerMill100: folds 
Oswood: calls €0.25
HomerrrJay: folds 
*** FLOP *** [Ah Qd 9s]
Oswood: checks 
Hero: bets €0.50
Oswood: folds 
Uncalled bet (€0.50) returned to Hero
Hero collected €0.67 from pot
*** SUMMARY ***
Total pot €0.70 | Rake €0.03 
Board [Ah Qd 9s]
Seat 1: Oswood (small blind) folded on the Flop
Seat 2: HomerrrJay (big blind) folded before Flop
Seat 3: andi661 folded before Flop (didn't bet)
Seat 4: Hero collected (€0.67)
Seat 5: Poptart74 folded before Flop (didn't bet)
Seat 6: PokerMill100 (button) folded before Flop (didn't bet)



PokerStars Game #35602295396:  Hold'em No Limit (€0.05/€0.10 EUR) - 2009/11/20 7:24:47 ET
Table 'Lampland' 6-max Seat #1 is the button
Seat 1: Oswood (€12.56 in chips) 
Seat 2: HomerrrJay (€10 in chips) 
Seat 3: andi661 (€2.23 in chips) 
Seat 4: Hero (€7.07 in chips) 
Seat 5: Poptart74 (€2.10 in chips) 
Seat 6: PokerMill100 (€9.11 in chips) 
HomerrrJay: posts small blind €0.05
andi661: posts big blind €0.10
*** HOLE CARDS ***
Dealt to Hero [4s 3d]
Hero: folds 
Poptart74: folds 
PokerMill100: raises €0.20 to €0.30
Oswood: folds 
HomerrrJay: folds 
andi661: folds 
Uncalled bet (€0.20) returned to PokerMill100
PokerMill100 collected €0.25 from pot
*** SUMMARY ***
Total pot €0.25 | Rake €0 
Seat 1: Oswood (button) folded before Flop (didn't bet)
Seat 2: HomerrrJay (small blind) folded before Flop
Seat 3: andi661 (big blind) folded before Flop
Seat 4: Hero folded before Flop (didn't bet)
Seat 5: Poptart74 folded before Flop (didn't bet)
Seat 6: PokerMill100 collected (€0.25)



PokerStars Game #35602302569:  Hold'em No Limit (€0.05/€0.10 EUR) - 2009/11/20 7:25:05 ET
Table 'Lampland' 6-max Seat #2 is the button
Seat 1: Oswood (€12.56 in chips) 
Seat 2: HomerrrJay (€10 in chips) 
Seat 3: andi661 (€2.13 in chips) 
Seat 4: Hero (€7.07 in chips) 
Seat 5: Poptart74 (€2.10 in chips) 
Seat 6: PokerMill100 (€9.26 in chips) 
andi661: posts small blind €0.05
Hero: posts big blind €0.10
*** HOLE CARDS ***
Dealt to Hero [As 8h]
Poptart74: folds 
PokerMill100: folds 
Oswood: folds 
HomerrrJay: folds 
andi661: calls €0.05
Hero: checks 
*** FLOP *** [5s Jd 2c]
andi661: checks 
Hero: checks 
*** TURN *** [5s Jd 2c] [8s]
andi661: bets €0.30
Hero: calls €0.30
*** RIVER *** [5s Jd 2c 8s] [7s]
andi661: bets €0.50
Hero: calls €0.50
*** SHOW DOWN ***
andi661: shows [6s 9d] (a straight, Five to Nine)
Hero: mucks hand 
andi661 collected €1.72 from pot
*** SUMMARY ***
Total pot €1.80 | Rake €0.08 
Board [5s Jd 2c 8s 7s]
Seat 1: Oswood folded before Flop (didn't bet)
Seat 2: HomerrrJay (button) folded before Flop (didn't bet)
Seat 3: andi661 (small blind) showed [6s 9d] and won (€1.72) with a straight, Five to Nine
Seat 4: Hero (big blind) mucked [As 8h]
Seat 5: Poptart74 folded before Flop (didn't bet)
Seat 6: PokerMill100 folded before Flop (didn't bet)



PokerStars Game #35602321212:  Hold'em No Limit (€0.05/€0.10 EUR) - 2009/11/20 7:25:54 ET
Table 'Lampland' 6-max Seat #3 is the button
Seat 1: Oswood (€12.56 in chips) 
Seat 2: HomerrrJay (€10 in chips) 
Seat 3: andi661 (€2.95 in chips) 
Seat 4: Hero (€6.17 in chips) 
Seat 5: Poptart74 (€2.10 in chips) 
Seat 6: PokerMill100 (€9.26 in chips) 
Hero: posts small blind €0.05
Poptart74: posts big blind €0.10
*** HOLE CARDS ***
Dealt to Hero [7s 6d]
PokerMill100: folds 
Oswood: folds 
HomerrrJay: folds 
andi661: calls €0.10
Hero: calls €0.05
Poptart74: checks 
*** FLOP *** [3h Ad Js]
Hero: checks 
Poptart74: checks 
andi661: checks 
*** TURN *** [3h Ad Js] [Jc]
Hero: checks 
Poptart74: checks 
andi661: bets €0.30
Hero: folds 
Poptart74: folds 
Uncalled bet (€0.30) returned to andi661
andi661 collected €0.29 from pot
*** SUMMARY ***
Total pot €0.30 | Rake €0.01 
Board [3h Ad Js Jc]
Seat 1: Oswood folded before Flop (didn't bet)
Seat 2: HomerrrJay folded before Flop (didn't bet)
Seat 3: andi661 (button) collected (€0.29)
Seat 4: Hero (small blind) folded on the Turn
Seat 5: Poptart74 (big blind) folded on the Turn
Seat 6: PokerMill100 folded before Flop (didn't bet)



PokerStars Game #35602339387:  Hold'em No Limit (€0.05/€0.10 EUR) - 2009/11/20 7:26:41 ET
Table 'Lampland' 6-max Seat #4 is the button
Seat 1: Oswood (€12.56 in chips) 
Seat 2: HomerrrJay (€10 in chips) 
Seat 3: andi661 (€3.14 in chips) 
Seat 4: Hero (€6.07 in chips) 
Seat 5: Poptart74 (€2 in chips) 
Seat 6: PokerMill100 (€9.26 in chips) 
Poptart74: posts small blind €0.05
PokerMill100: posts big blind €0.10
*** HOLE CARDS ***
Dealt to Hero [Kd 7h]
Oswood: folds 
HomerrrJay: raises €0.20 to €0.30
andi661: folds 
Hero: folds 
Poptart74: folds 
PokerMill100: calls €0.20
*** FLOP *** [7c Qc 6c]
PokerMill100: checks 
HomerrrJay: bets €0.20
PokerMill100: calls €0.20
*** TURN *** [7c Qc 6c] [Kh]
PokerMill100: checks 
HomerrrJay: bets €0.50
PokerMill100: calls €0.50
*** RIVER *** [7c Qc 6c Kh] [2d]
PokerMill100: checks 
HomerrrJay: bets €1.40
PokerMill100: folds 
Uncalled bet (€1.40) returned to HomerrrJay
HomerrrJay collected €1.95 from pot
HomerrrJay: doesn't show hand 
*** SUMMARY ***
Total pot €2.05 | Rake €0.10 
Board [7c Qc 6c Kh 2d]
Seat 1: Oswood folded before Flop (didn't bet)
Seat 2: HomerrrJay collected (€1.95)
Seat 3: andi661 folded before Flop (didn't bet)
Seat 4: Hero (button) folded before Flop (didn't bet)
Seat 5: Poptart74 (small blind) folded before Flop
Seat 6: PokerMill100 (big blind) folded on the River



PokerStars Game #35602354207:  Hold'em No Limit (€0.05/€0.10 EUR) - 2009/11/20 7:27:22 ET
Table 'Lampland' 6-max Seat #5 is the button
Seat 1: Oswood (€12.56 in chips) 
Seat 2: HomerrrJay (€10.95 in chips) 
Seat 3: andi661 (€3.14 in chips) 
Seat 4: Hero (€6.07 in chips) 
Seat 5: Poptart74 (€1.95 in chips) 
Seat 6: PokerMill100 (€8.26 in chips) 
PokerMill100: posts small blind €0.05
Oswood: posts big blind €0.10
*** HOLE CARDS ***
Dealt to Hero [6d Ac]
HomerrrJay: folds 
andi661: calls €0.10
Hero: folds 
Poptart74: folds 
PokerMill100: calls €0.05
Oswood: checks 
*** FLOP *** [6c 4h Kh]
PokerMill100: checks 
Oswood: checks 
andi661: bets €0.10
PokerMill100: raises €0.20 to €0.30
Oswood: folds 
andi661: folds 
Uncalled bet (€0.20) returned to PokerMill100
PokerMill100 collected €0.48 from pot
PokerMill100: doesn't show hand 
*** SUMMARY ***
Total pot €0.50 | Rake €0.02 
Board [6c 4h Kh]
Seat 1: Oswood (big blind) folded on the Flop
Seat 2: HomerrrJay folded before Flop (didn't bet)
Seat 3: andi661 folded on the Flop
Seat 4: Hero folded before Flop (didn't bet)
Seat 5: Poptart74 (button) folded before Flop (didn't bet)
Seat 6: PokerMill100 (small blind) collected (€0.48)



PokerStars Game #35602372046:  Hold'em No Limit (€0.05/€0.10 EUR) - 2009/11/20 7:28:07 ET
Table 'Lampland' 6-max Seat #6 is the button
Seat 1: Oswood (€12.46 in chips) 
Seat 2: HomerrrJay (€10.95 in chips) 
Seat 3: andi661 (€2.94 in chips) 
Seat 4: Hero (€6.07 in chips) 
Seat 5: Poptart74 (€1.95 in chips) 
Seat 6: PokerMill100 (€8.54 in chips) 
Oswood: posts small blind €0.05
HomerrrJay: posts big blind €0.10
*** HOLE CARDS ***
Dealt to Hero [Qs Qc]
andi661: folds 
Hero: raises €0.20 to €0.30
Poptart74: folds 
PokerMill100: raises €0.50 to €0.80
Oswood: folds 
HomerrrJay: folds 
Hero: raises €1.60 to €2.40
PokerMill100: calls €1.60
*** FLOP *** [5c 8c 7c]
Hero: bets €3.67 and is all-in
PokerMill100: calls €3.67
*** TURN *** [5c 8c 7c] [9h]
*** RIVER *** [5c 8c 7c 9h] [2h]
*** SHOW DOWN ***
Hero: shows [Qs Qc] (a pair of Queens)
PokerMill100: shows [Qd Ac] (high card Ace)
Hero collected €11.69 from pot
*** SUMMARY ***
Total pot €12.29 | Rake €0.60 
Board [5c 8c 7c 9h 2h]
Seat 1: Oswood (small blind) folded before Flop
Seat 2: HomerrrJay (big blind) folded before Flop
Seat 3: andi661 folded before Flop (didn't bet)
Seat 4: Hero showed [Qs Qc] and won (€11.69) with a pair of Queens
Seat 5: Poptart74 folded before Flop (didn't bet)
Seat 6: PokerMill100 (button) showed [Qd Ac] and lost with high card Ace



PokerStars Game #35602388985:  Hold'em No Limit (€0.05/€0.10 EUR) - 2009/11/20 7:28:52 ET
Table 'Lampland' 6-max Seat #1 is the button
Seat 1: Oswood (€12.41 in chips) 
Seat 2: HomerrrJay (€10.85 in chips) 
Seat 3: andi661 (€2.94 in chips) 
Seat 4: Hero (€11.69 in chips) 
Seat 5: Poptart74 (€1.95 in chips) 
Seat 6: PokerMill100 (€2.47 in chips) 
HomerrrJay: posts small blind €0.05
andi661: posts big blind €0.10
*** HOLE CARDS ***
Dealt to Hero [As 8s]
Hero: raises €0.20 to €0.30
Poptart74: folds 
PokerMill100: raises €0.30 to €0.60
Oswood: folds 
HomerrrJay: folds 
andi661: folds 
Hero: calls €0.30
*** FLOP *** [2h 7h Qc]
Hero: checks 
PokerMill100: bets €0.50
Hero: folds 
Uncalled bet (€0.50) returned to PokerMill100
PokerMill100 collected €1.29 from pot
PokerMill100: doesn't show hand 
*** SUMMARY ***
Total pot €1.35 | Rake €0.06 
Board [2h 7h Qc]
Seat 1: Oswood (button) folded before Flop (didn't bet)
Seat 2: HomerrrJay (small blind) folded before Flop
Seat 3: andi661 (big blind) folded before Flop
Seat 4: Hero folded on the Flop
Seat 5: Poptart74 folded before Flop (didn't bet)
Seat 6: PokerMill100 collected (€1.29)



PokerStars Game #35602399936:  Hold'em No Limit (€0.05/€0.10 EUR) - 2009/11/20 7:29:21 ET
Table 'Lampland' 6-max Seat #2 is the button
Seat 1: Oswood (€12.41 in chips) 
Seat 2: HomerrrJay (€10.80 in chips) 
Seat 3: andi661 (€2.84 in chips) 
Seat 4: Hero (€11.09 in chips) 
Seat 5: Poptart74 (€1.95 in chips) 
Seat 6: PokerMill100 (€3.16 in chips) 
andi661: posts small blind €0.05
Hero: posts big blind €0.10
*** HOLE CARDS ***
Dealt to Hero [9h 9d]
Poptart74: folds 
PokerMill100: folds 
Oswood has timed out
Oswood: folds 
Oswood is sitting out
Oswood has returned
HomerrrJay: raises €0.20 to €0.30
andi661: folds 
Hero: calls €0.20
*** FLOP *** [4h 9s Qc]
Hero: checks 
HomerrrJay: bets €0.40
Hero: raises €1 to €1.40
HomerrrJay: folds 
Uncalled bet (€1) returned to Hero
Hero collected €1.38 from pot
*** SUMMARY ***
Total pot €1.45 | Rake €0.07 
Board [4h 9s Qc]
Seat 1: Oswood folded before Flop (didn't bet)
Seat 2: HomerrrJay (button) folded on the Flop
Seat 3: andi661 (small blind) folded before Flop
Seat 4: Hero (big blind) collected (€1.38)
Seat 5: Poptart74 folded before Flop (didn't bet)
Seat 6: PokerMill100 folded before Flop (didn't bet)



PokerStars Game #35602418215:  Hold'em No Limit (€0.05/€0.10 EUR) - 2009/11/20 7:30:09 ET
Table 'Lampland' 6-max Seat #3 is the button
Seat 1: Oswood (€12.41 in chips) 
Seat 2: HomerrrJay (€10.10 in chips) 
Seat 3: andi661 (€2.79 in chips) 
Seat 4: Hero (€11.77 in chips) 
Seat 5: Poptart74 (€1.95 in chips) 
Seat 6: PokerMill100 (€3.16 in chips) 
Hero: posts small blind €0.05
Poptart74: posts big blind €0.10
*** HOLE CARDS ***
Dealt to Hero [Qd 3s]
PokerMill100: folds 
Oswood has timed out
Oswood: folds 
Oswood is sitting out
HomerrrJay: folds 
andi661: calls €0.10
Hero: folds 
Poptart74: checks 
*** FLOP *** [7d Kd 6h]
Poptart74: checks 
andi661: bets €0.20
Poptart74: folds 
Uncalled bet (€0.20) returned to andi661
andi661 collected €0.24 from pot
*** SUMMARY ***
Total pot €0.25 | Rake €0.01 
Board [7d Kd 6h]
Seat 1: Oswood folded before Flop (didn't bet)
Seat 2: HomerrrJay folded before Flop (didn't bet)
Seat 3: andi661 (button) collected (€0.24)
Seat 4: Hero (small blind) folded before Flop
Seat 5: Poptart74 (big blind) folded on the Flop
Seat 6: PokerMill100 folded before Flop (didn't bet)



PokerStars Game #35602435059:  Hold'em No Limit (€0.05/€0.10 EUR) - 2009/11/20 7:30:53 ET
Table 'Lampland' 6-max Seat #4 is the button
Seat 2: HomerrrJay (€10.10 in chips) 
Seat 3: andi661 (€2.93 in chips) 
Seat 4: Hero (€11.72 in chips) 
Seat 5: Poptart74 (€1.85 in chips) 
Seat 6: PokerMill100 (€3.16 in chips) 
Poptart74: posts small blind €0.05
PokerMill100: posts big blind €0.10
*** HOLE CARDS ***
Dealt to Hero [9h Tc]
HomerrrJay: raises €0.30 to €0.40
andi661: calls €0.40
Hero: folds 
Poptart74: folds 
PokerMill100: folds 
*** FLOP *** [Kc Kh As]
HomerrrJay: checks 
andi661: checks 
*** TURN *** [Kc Kh As] [9c]
HomerrrJay: bets €0.30
andi661: folds 
Uncalled bet (€0.30) returned to HomerrrJay
HomerrrJay collected €0.91 from pot
HomerrrJay: doesn't show hand 
*** SUMMARY ***
Total pot €0.95 | Rake €0.04 
Board [Kc Kh As 9c]
Seat 2: HomerrrJay collected (€0.91)
Seat 3: andi661 folded on the Turn
Seat 4: Hero (button) folded before Flop (didn't bet)
Seat 5: Poptart74 (small blind) folded before Flop
Seat 6: PokerMill100 (big blind) folded before Flop



PokerStars Game #35602449190:  Hold'em No Limit (€0.05/€0.10 EUR) - 2009/11/20 7:31:29 ET
Table 'Lampland' 6-max Seat #5 is the button
Seat 2: HomerrrJay (€10.61 in chips) 
Seat 3: andi661 (€2.53 in chips) 
Seat 4: Hero (€11.72 in chips) 
Seat 5: Poptart74 (€1.80 in chips) 
Seat 6: PokerMill100 (€3.06 in chips) 
PokerMill100: posts small blind €0.05
HomerrrJay: posts big blind €0.10
*** HOLE CARDS ***
Dealt to Hero [4d Ac]
andi661: raises €0.10 to €0.20
Hero: folds 
Poptart74: folds 
PokerMill100: folds 
HomerrrJay: folds 
Uncalled bet (€0.10) returned to andi661
andi661 collected €0.25 from pot
*** SUMMARY ***
Total pot €0.25 | Rake €0 
Seat 2: HomerrrJay (big blind) folded before Flop
Seat 3: andi661 collected (€0.25)
Seat 4: Hero folded before Flop (didn't bet)
Seat 5: Poptart74 (button) folded before Flop (didn't bet)
Seat 6: PokerMill100 (small blind) folded before Flop



PokerStars Game #35602454945:  Hold'em No Limit (€0.05/€0.10 EUR) - 2009/11/20 7:31:45 ET
Table 'Lampland' 6-max Seat #6 is the button
Seat 2: HomerrrJay (€10.51 in chips) 
Seat 3: andi661 (€2.68 in chips) 
Seat 4: Hero (€11.72 in chips) 
Seat 5: Poptart74 (€1.80 in chips) 
Seat 6: PokerMill100 (€3.01 in chips) 
HomerrrJay: posts small blind €0.05
andi661: posts big blind €0.10
*** HOLE CARDS ***
Dealt to Hero [Qh 3c]
Hero: folds 
Poptart74: calls €0.10
PokerMill100: calls €0.10
HomerrrJay: calls €0.05
andi661: checks 
*** FLOP *** [9s 8h 8d]
HomerrrJay: bets €0.20
andi661: calls €0.20
Poptart74: folds 
PokerMill100: folds 
*** TURN *** [9s 8h 8d] [Qc]
HomerrrJay: bets €0.20
andi661: raises €0.30 to €0.50
HomerrrJay: calls €0.30
*** RIVER *** [9s 8h 8d Qc] [Td]
HomerrrJay: checks 
andi661: bets €1
HomerrrJay: folds 
Uncalled bet (€1) returned to andi661
andi661 collected €1.72 from pot
*** SUMMARY ***
Total pot €1.80 | Rake €0.08 
Board [9s 8h 8d Qc Td]
Seat 2: HomerrrJay (small blind) folded on the River
Seat 3: andi661 (big blind) collected (€1.72)
Seat 4: Hero folded before Flop (didn't bet)
Seat 5: Poptart74 folded on the Flop
Seat 6: PokerMill100 (button) folded on the Flop



PokerStars Game #35602472519:  Hold'em No Limit (€0.05/€0.10 EUR) - 2009/11/20 7:32:30 ET
Table 'Lampland' 6-max Seat #2 is the button
Seat 2: HomerrrJay (€10 in chips) 
Seat 3: andi661 (€3.60 in chips) 
Seat 4: Hero (€11.72 in chips) 
Seat 5: Poptart74 (€1.70 in chips) 
Seat 6: PokerMill100 (€2.91 in chips) 
andi661: posts small blind €0.05
Hero: posts big blind €0.10
*** HOLE CARDS ***
Dealt to Hero [Ah Th]
Poptart74: calls €0.10
PokerMill100: folds 
HomerrrJay: folds 
andi661: calls €0.05
Hero: checks 
*** FLOP *** [As Js 8s]
andi661: checks 
Hero: checks 
Poptart74: checks 
*** TURN *** [As Js 8s] [8c]
andi661: bets €0.20
Hero: calls €0.20
Poptart74: folds 
*** RIVER *** [As Js 8s 8c] [3c]
andi661: bets €0.50
Hero: calls €0.50
*** SHOW DOWN ***
andi661: shows [Jd 9h] (two pair, Jacks and Eights)
Hero: shows [Ah Th] (two pair, Aces and Eights)
Hero collected €1.62 from pot
*** SUMMARY ***
Total pot €1.70 | Rake €0.08 
Board [As Js 8s 8c 3c]
Seat 2: HomerrrJay (button) folded before Flop (didn't bet)
Seat 3: andi661 (small blind) showed [Jd 9h] and lost with two pair, Jacks and Eights
Seat 4: Hero (big blind) showed [Ah Th] and won (€1.62) with two pair, Aces and Eights
Seat 5: Poptart74 folded on the Turn
Seat 6: PokerMill100 folded before Flop (didn't bet)



PokerStars Game #35602487338:  Hold'em No Limit (€0.05/€0.10 EUR) - 2009/11/20 7:33:09 ET
Table 'Lampland' 6-max Seat #3 is the button
Seat 2: HomerrrJay (€10 in chips) 
Seat 3: andi661 (€2.80 in chips) 
Seat 4: Hero (€12.54 in chips) 
Seat 5: Poptart74 (€1.60 in chips) 
Seat 6: PokerMill100 (€2.91 in chips) 
Hero: posts small blind €0.05
Poptart74: posts big blind €0.10
*** HOLE CARDS ***
Dealt to Hero [Qd Td]
PokerMill100: folds 
HomerrrJay: folds 
andi661: calls €0.10
Hero: calls €0.05
Poptart74: checks 
*** FLOP *** [4s 8d 6h]
Hero: checks 
Poptart74: checks 
andi661: bets €0.20
Hero: folds 
Poptart74: calls €0.20
*** TURN *** [4s 8d 6h] [Kc]
Poptart74: checks 
andi661: bets €0.30
Poptart74: calls €0.30
*** RIVER *** [4s 8d 6h Kc] [Qc]
Poptart74: checks 
andi661: bets €0.50
Poptart74: calls €0.50
*** SHOW DOWN ***
andi661: shows [3h 3c] (a pair of Threes)
Poptart74: shows [5h 6c] (a pair of Sixes)
Poptart74 collected €2.19 from pot
*** SUMMARY ***
Total pot €2.30 | Rake €0.11 
Board [4s 8d 6h Kc Qc]
Seat 2: HomerrrJay folded before Flop (didn't bet)
Seat 3: andi661 (button) showed [3h 3c] and lost with a pair of Threes
Seat 4: Hero (small blind) folded on the Flop
Seat 5: Poptart74 (big blind) showed [5h 6c] and won (€2.19) with a pair of Sixes
Seat 6: PokerMill100 folded before Flop (didn't bet)



PokerStars Game #35602509002:  Hold'em No Limit (€0.05/€0.10 EUR) - 2009/11/20 7:34:05 ET
Table 'Lampland' 6-max Seat #4 is the button
Seat 2: HomerrrJay (€10 in chips) 
Seat 3: andi661 (€1.70 in chips) 
Seat 4: Hero (€12.44 in chips) 
Seat 5: Poptart74 (€2.69 in chips) 
Seat 6: PokerMill100 (€2.91 in chips) 
Poptart74: posts small blind €0.05
PokerMill100: posts big blind €0.10
*** HOLE CARDS ***
Dealt to Hero [Kd 5d]
HomerrrJay: folds 
andi661: calls €0.10
Hero: folds 
Poptart74: calls €0.05
PokerMill100: checks 
*** FLOP *** [Ts 8c Qc]
Poptart74: checks 
PokerMill100: checks 
andi661: bets €0.30
Poptart74: calls €0.30
PokerMill100: folds 
*** TURN *** [Ts 8c Qc] [7s]
Poptart74: checks 
andi661: bets €1.30 and is all-in
Poptart74: calls €1.30
*** RIVER *** [Ts 8c Qc 7s] [Qh]
*** SHOW DOWN ***
Poptart74: shows [8s 9s] (two pair, Queens and Eights)
andi661: shows [Jd Th] (two pair, Queens and Tens)
andi661 collected €3.33 from pot
*** SUMMARY ***
Total pot €3.50 | Rake €0.17 
Board [Ts 8c Qc 7s Qh]
Seat 2: HomerrrJay folded before Flop (didn't bet)
Seat 3: andi661 showed [Jd Th] and won (€3.33) with two pair, Queens and Tens
Seat 4: Hero (button) folded before Flop (didn't bet)
Seat 5: Poptart74 (small blind) showed [8s 9s] and lost with two pair, Queens and Eights
Seat 6: PokerMill100 (big blind) folded on the Flop



PokerStars Game #35602528089:  Hold'em No Limit (€0.05/€0.10 EUR) - 2009/11/20 7:34:54 ET
Table 'Lampland' 6-max Seat #5 is the button
Seat 2: HomerrrJay (€10 in chips) 
Seat 3: andi661 (€3.33 in chips) 
Seat 4: Hero (€12.44 in chips) 
Seat 5: Poptart74 (€0.99 in chips) 
Seat 6: PokerMill100 (€2.81 in chips) 
PokerMill100: posts small blind €0.05
HomerrrJay: posts big blind €0.10
*** HOLE CARDS ***
Dealt to Hero [7d Th]
andi661: folds 
Hero: folds 
Poptart74: folds 
PokerMill100: folds 
Uncalled bet (€0.05) returned to HomerrrJay
HomerrrJay collected €0.10 from pot
HomerrrJay: doesn't show hand 
*** SUMMARY ***
Total pot €0.10 | Rake €0 
Seat 2: HomerrrJay (big blind) collected (€0.10)
Seat 3: andi661 folded before Flop (didn't bet)
Seat 4: Hero folded before Flop (didn't bet)
Seat 5: Poptart74 (button) folded before Flop (didn't bet)
Seat 6: PokerMill100 (small blind) folded before Flop



PokerStars Game #35602532574:  Hold'em No Limit (€0.05/€0.10 EUR) - 2009/11/20 7:35:06 ET
Table 'Lampland' 6-max Seat #6 is the button
Seat 2: HomerrrJay (€10.05 in chips) 
Seat 3: andi661 (€3.33 in chips) 
Seat 4: Hero (€12.44 in chips) 
Seat 5: Poptart74 (€0.99 in chips) 
Seat 6: PokerMill100 (€2.76 in chips) 
HomerrrJay: posts small blind €0.05
andi661: posts big blind €0.10
*** HOLE CARDS ***
Dealt to Hero [6d Qh]
Hero: folds 
Poptart74: folds 
PokerMill100: folds 
HomerrrJay: folds 
Uncalled bet (€0.05) returned to andi661
andi661 collected €0.10 from pot
*** SUMMARY ***
Total pot €0.10 | Rake €0 
Seat 2: HomerrrJay (small blind) folded before Flop
Seat 3: andi661 (big blind) collected (€0.10)
Seat 4: Hero folded before Flop (didn't bet)
Seat 5: Poptart74 folded before Flop (didn't bet)
Seat 6: PokerMill100 (button) folded before Flop (didn't bet)



PokerStars Game #35602538264:  Hold'em No Limit (€0.05/€0.10 EUR) - 2009/11/20 7:35:21 ET
Table 'Lampland' 6-max Seat #2 is the button
Seat 2: HomerrrJay (€10 in chips) 
Seat 3: andi661 (€3.38 in chips) 
Seat 4: Hero (€12.44 in chips) 
Seat 5: Poptart74 (€0.99 in chips) 
Seat 6: PokerMill100 (€2.76 in chips) 
andi661: posts small blind €0.05
Hero: posts big blind €0.10
*** HOLE CARDS ***
Dealt to Hero [4h Jh]
Poptart74: folds 
PokerMill100: raises €0.20 to €0.30
HomerrrJay: folds 
andi661: folds 
Hero: folds 
Uncalled bet (€0.20) returned to PokerMill100
PokerMill100 collected €0.25 from pot
PokerMill100: doesn't show hand 
*** SUMMARY ***
Total pot €0.25 | Rake €0 
Seat 2: HomerrrJay (button) folded before Flop (didn't bet)
Seat 3: andi661 (small blind) folded before Flop
Seat 4: Hero (big blind) folded before Flop
Seat 5: Poptart74 folded before Flop (didn't bet)
Seat 6: PokerMill100 collected (€0.25)



PokerStars Game #35602543794:  Hold'em No Limit (€0.05/€0.10 EUR) - 2009/11/20 7:35:36 ET
Table 'Lampland' 6-max Seat #3 is the button
Seat 2: HomerrrJay (€10 in chips) 
Seat 3: andi661 (€3.33 in chips) 
Seat 4: Hero (€12.34 in chips) 
Seat 5: Poptart74 (€0.99 in chips) 
Seat 6: PokerMill100 (€2.91 in chips) 
Hero: posts small blind €0.05
Poptart74: posts big blind €0.10
*** HOLE CARDS ***
Dealt to Hero [Qs 4c]
PokerMill100: raises €0.30 to €0.40
HomerrrJay: folds 
andi661: folds 
Hero: folds 
Poptart74: folds 
Uncalled bet (€0.30) returned to PokerMill100
PokerMill100 collected €0.25 from pot
*** SUMMARY ***
Total pot €0.25 | Rake €0 
Seat 2: HomerrrJay folded before Flop (didn't bet)
Seat 3: andi661 (button) folded before Flop (didn't bet)
Seat 4: Hero (small blind) folded before Flop
Seat 5: Poptart74 (big blind) folded before Flop
Seat 6: PokerMill100 collected (€0.25)



PokerStars Game #35602548453:  Hold'em No Limit (€0.05/€0.10 EUR) - 2009/11/20 7:35:48 ET
Table 'Lampland' 6-max Seat #4 is the button
Seat 2: HomerrrJay (€10 in chips) 
Seat 3: andi661 (€3.33 in chips) 
Seat 4: Hero (€12.29 in chips) 
Seat 5: Poptart74 (€0.89 in chips) 
Seat 6: PokerMill100 (€3.06 in chips) 
Poptart74: posts small blind €0.05
PokerMill100: posts big blind €0.10
*** HOLE CARDS ***
Dealt to Hero [Jh 6c]
HomerrrJay: folds 
andi661: calls €0.10
Hero: folds 
Poptart74: calls €0.05
PokerMill100: checks 
*** FLOP *** [Td 9s Kc]
Poptart74: checks 
PokerMill100: checks 
andi661: checks 
*** TURN *** [Td 9s Kc] [9h]
Poptart74: checks 
PokerMill100: checks 
andi661: checks 
*** RIVER *** [Td 9s Kc 9h] [8h]
Poptart74: checks 
PokerMill100: checks 
andi661: bets €0.30
Poptart74: calls €0.30
PokerMill100: folds 
*** SHOW DOWN ***
andi661: shows [3h 4h] (a pair of Nines)
Poptart74: shows [Qh Ts] (two pair, Tens and Nines)
Poptart74 collected €0.86 from pot
*** SUMMARY ***
Total pot €0.90 | Rake €0.04 
Board [Td 9s Kc 9h 8h]
Seat 2: HomerrrJay folded before Flop (didn't bet)
Seat 3: andi661 showed [3h 4h] and lost with a pair of Nines
Seat 4: Hero (button) folded before Flop (didn't bet)
Seat 5: Poptart74 (small blind) showed [Qh Ts] and won (€0.86) with two pair, Tens and Nines
Seat 6: PokerMill100 (big blind) folded on the River



PokerStars Game #35602569251:  Hold'em No Limit (€0.05/€0.10 EUR) - 2009/11/20 7:36:43 ET
Table 'Lampland' 6-max Seat #5 is the button
Seat 2: HomerrrJay (€10 in chips) 
Seat 3: andi661 (€2.93 in chips) 
Seat 4: Hero (€12.29 in chips) 
Seat 5: Poptart74 (€1.35 in chips) 
Seat 6: PokerMill100 (€2.96 in chips) 
PokerMill100: posts small blind €0.05
HomerrrJay: posts big blind €0.10
*** HOLE CARDS ***
Dealt to Hero [Jh 5s]
andi661: folds 
Hero: folds 
Poptart74: calls €0.10
PokerMill100: raises €0.30 to €0.40
HomerrrJay: folds 
Poptart74: folds 
Uncalled bet (€0.30) returned to PokerMill100
PokerMill100 collected €0.30 from pot
*** SUMMARY ***
Total pot €0.30 | Rake €0 
Seat 2: HomerrrJay (big blind) folded before Flop
Seat 3: andi661 folded before Flop (didn't bet)
Seat 4: Hero folded before Flop (didn't bet)
Seat 5: Poptart74 (button) folded before Flop
Seat 6: PokerMill100 (small blind) collected (€0.30)



PokerStars Game #35602575727:  Hold'em No Limit (€0.05/€0.10 EUR) - 2009/11/20 7:36:59 ET
Table 'Lampland' 6-max Seat #6 is the button
Seat 2: HomerrrJay (€10 in chips) 
Seat 3: andi661 (€2.93 in chips) 
Seat 4: Hero (€12.29 in chips) 
Seat 5: Poptart74 (€1.25 in chips) 
Seat 6: PokerMill100 (€3.16 in chips) 
HomerrrJay: posts small blind €0.05
andi661: posts big blind €0.10
*** HOLE CARDS ***
Dealt to Hero [4d 2c]
Hero: folds 
Poptart74: raises €0.20 to €0.30
PokerMill100: calls €0.30
HomerrrJay: folds 
andi661: calls €0.20
*** FLOP *** [7c 8h 9h]
andi661: checks 
Poptart74: checks 
PokerMill100: checks 
*** TURN *** [7c 8h 9h] [3d]
andi661: checks 
Poptart74: bets €0.30
PokerMill100: calls €0.30
andi661: folds 
*** RIVER *** [7c 8h 9h 3d] [7d]
Poptart74: checks 
PokerMill100: bets €0.70
Poptart74: folds 
Uncalled bet (€0.70) returned to PokerMill100
PokerMill100 collected €1.48 from pot
PokerMill100: doesn't show hand 
*** SUMMARY ***
Total pot €1.55 | Rake €0.07 
Board [7c 8h 9h 3d 7d]
Seat 2: HomerrrJay (small blind) folded before Flop
Seat 3: andi661 (big blind) folded on the Turn
Seat 4: Hero folded before Flop (didn't bet)
Seat 5: Poptart74 folded on the River
Seat 6: PokerMill100 (button) collected (€1.48)



PokerStars Game #35602599492:  Hold'em No Limit (€0.05/€0.10 EUR) - 2009/11/20 7:38:01 ET
Table 'Lampland' 6-max Seat #2 is the button
Seat 2: HomerrrJay (€10 in chips) 
Seat 3: andi661 (€2.63 in chips) 
Seat 4: Hero (€12.29 in chips) 
Seat 5: Poptart74 (€0.65 in chips) 
Seat 6: PokerMill100 (€4.04 in chips) 
andi661: posts small blind €0.05
Hero: posts big blind €0.10
*** HOLE CARDS ***
Dealt to Hero [5d 6d]
Poptart74: raises €0.55 to €0.65 and is all-in
PokerMill100: folds 
HomerrrJay: folds 
andi661: folds 
Hero: calls €0.55
*** FLOP *** [9c 2c 7d]
*** TURN *** [9c 2c 7d] [Jc]
*** RIVER *** [9c 2c 7d Jc] [Jd]
*** SHOW DOWN ***
Hero: shows [5d 6d] (a pair of Jacks)
Poptart74: shows [7h Kh] (two pair, Jacks and Sevens)
Poptart74 collected €1.29 from pot
*** SUMMARY ***
Total pot €1.35 | Rake €0.06 
Board [9c 2c 7d Jc Jd]
Seat 2: HomerrrJay (button) folded before Flop (didn't bet)
Seat 3: andi661 (small blind) folded before Flop
Seat 4: Hero (big blind) showed [5d 6d] and lost with a pair of Jacks
Seat 5: Poptart74 showed [7h Kh] and won (€1.29) with two pair, Jacks and Sevens
Seat 6: PokerMill100 folded before Flop (didn't bet)



PokerStars Game #35602610521:  Hold'em No Limit (€0.05/€0.10 EUR) - 2009/11/20 7:38:30 ET
Table 'Lampland' 6-max Seat #3 is the button
Seat 2: HomerrrJay (€10 in chips) 
Seat 3: andi661 (€2.58 in chips) 
Seat 4: Hero (€11.64 in chips) 
Seat 5: Poptart74 (€1.29 in chips) 
Seat 6: PokerMill100 (€4.04 in chips) 
Hero: posts small blind €0.05
Poptart74: posts big blind €0.10
*** HOLE CARDS ***
Dealt to Hero [5h Jc]
PokerMill100: folds 
HomerrrJay: folds 
andi661: folds 
Hero: folds 
Uncalled bet (€0.05) returned to Poptart74
Poptart74 collected €0.10 from pot
Poptart74: doesn't show hand 
*** SUMMARY ***
Total pot €0.10 | Rake €0 
Seat 2: HomerrrJay folded before Flop (didn't bet)
Seat 3: andi661 (button) folded before Flop (didn't bet)
Seat 4: Hero (small blind) folded before Flop
Seat 5: Poptart74 (big blind) collected (€0.10)
Seat 6: PokerMill100 folded before Flop (didn't bet)



PokerStars Game #35602613846:  Hold'em No Limit (€0.05/€0.10 EUR) - 2009/11/20 7:38:39 ET
Table 'Lampland' 6-max Seat #4 is the button
Seat 2: HomerrrJay (€10 in chips) 
Seat 3: andi661 (€2.58 in chips) 
Seat 4: Hero (€11.59 in chips) 
Seat 5: Poptart74 (€1.34 in chips) 
Seat 6: PokerMill100 (€4.04 in chips) 
Poptart74: posts small blind €0.05
PokerMill100: posts big blind €0.10
*** HOLE CARDS ***
Dealt to Hero [Td 5c]
HomerrrJay: folds 
andi661: folds 
Hero: folds 
Poptart74: calls €0.05
PokerMill100: raises €0.20 to €0.30
Poptart74: folds 
Uncalled bet (€0.20) returned to PokerMill100
PokerMill100 collected €0.20 from pot
*** SUMMARY ***
Total pot €0.20 | Rake €0 
Seat 2: HomerrrJay folded before Flop (didn't bet)
Seat 3: andi661 folded before Flop (didn't bet)
Seat 4: Hero (button) folded before Flop (didn't bet)
Seat 5: Poptart74 (small blind) folded before Flop
Seat 6: PokerMill100 (big blind) collected (€0.20)



PokerStars Game #35602622054:  Hold'em No Limit (€0.05/€0.10 EUR) - 2009/11/20 7:39:00 ET
Table 'Lampland' 6-max Seat #5 is the button
Seat 2: HomerrrJay (€10 in chips) 
Seat 3: andi661 (€2.58 in chips) 
Seat 4: Hero (€11.59 in chips) 
Seat 5: Poptart74 (€1.24 in chips) 
Seat 6: PokerMill100 (€4.14 in chips) 
PokerMill100: posts small blind €0.05
HomerrrJay: posts big blind €0.10
*** HOLE CARDS ***
Dealt to Hero [3s Qd]
andi661: raises €0.20 to €0.30
Hero: folds 
Poptart74: calls €0.30
PokerMill100: calls €0.25
HomerrrJay: calls €0.20
*** FLOP *** [Kh 8h 9d]
PokerMill100: checks 
HomerrrJay: bets €0.70
andi661: calls €0.70
Poptart74: raises €0.24 to €0.94 and is all-in
PokerMill100: folds 
HomerrrJay: calls €0.24
andi661: calls €0.24
*** TURN *** [Kh 8h 9d] [4d]
HomerrrJay: checks 
andi661: checks 
*** RIVER *** [Kh 8h 9d 4d] [9h]
HomerrrJay: checks 
andi661: checks 
*** SHOW DOWN ***
HomerrrJay: shows [9s Js] (three of a kind, Nines)
andi661: shows [Jc Qc] (a pair of Nines)
Poptart74: mucks hand 
HomerrrJay collected €3.83 from pot
*** SUMMARY ***
Total pot €4.02 | Rake €0.19 
Board [Kh 8h 9d 4d 9h]
Seat 2: HomerrrJay (big blind) showed [9s Js] and won (€3.83) with three of a kind, Nines
Seat 3: andi661 showed [Jc Qc] and lost with a pair of Nines
Seat 4: Hero folded before Flop (didn't bet)
Seat 5: Poptart74 (button) mucked [Tc Kd]
Seat 6: PokerMill100 (small blind) folded on the Flop



PokerStars Game #35602639577:  Hold'em No Limit (€0.05/€0.10 EUR) - 2009/11/20 7:39:46 ET
Table 'Lampland' 6-max Seat #6 is the button
Seat 2: HomerrrJay (€12.59 in chips) 
Seat 3: andi661 (€1.34 in chips) 
Seat 4: Hero (€11.59 in chips) 
Seat 6: PokerMill100 (€3.84 in chips) 
Oswood was removed from the table for failing to post
HomerrrJay: posts small blind €0.05
andi661: posts big blind €0.10
*** HOLE CARDS ***
Dealt to Hero [3d 7d]
Hero: folds 
PokerMill100: folds 
Poptart74 leaves the table
HomerrrJay: raises €0.20 to €0.30
andi661: calls €0.20
*** FLOP *** [9c 2c 9h]
HomerrrJay: checks 
andi661: checks 
*** TURN *** [9c 2c 9h] [Qc]
HomerrrJay: bets €0.40
andi661: folds 
Uncalled bet (€0.40) returned to HomerrrJay
HomerrrJay collected €0.57 from pot
HomerrrJay: doesn't show hand 
*** SUMMARY ***
Total pot €0.60 | Rake €0.03 
Board [9c 2c 9h Qc]
Seat 2: HomerrrJay (small blind) collected (€0.57)
Seat 3: andi661 (big blind) folded on the Turn
Seat 4: Hero folded before Flop (didn't bet)
Seat 6: PokerMill100 (button) folded before Flop (didn't bet)



PokerStars Game #35602648744:  Hold'em No Limit (€0.05/€0.10 EUR) - 2009/11/20 7:40:10 ET
Table 'Lampland' 6-max Seat #2 is the button
Seat 2: HomerrrJay (€12.86 in chips) 
Seat 3: andi661 (€1.04 in chips) 
Seat 4: Hero (€11.59 in chips) 
Seat 6: PokerMill100 (€3.84 in chips) 
andi661: posts small blind €0.05
Hero: posts big blind €0.10
*** HOLE CARDS ***
Dealt to Hero [6c Qc]
PokerMill100: folds 
HomerrrJay: folds 
andi661: calls €0.05
Hero: checks 
*** FLOP *** [5d Ac 3d]
andi661: checks 
Hero: checks 
*** TURN *** [5d Ac 3d] [Td]
andi661: bets €0.20
Hero: folds 
Uncalled bet (€0.20) returned to andi661
andi661 collected €0.19 from pot
*** SUMMARY ***
Total pot €0.20 | Rake €0.01 
Board [5d Ac 3d Td]
Seat 2: HomerrrJay (button) folded before Flop (didn't bet)
Seat 3: andi661 (small blind) collected (€0.19)
Seat 4: Hero (big blind) folded on the Turn
Seat 6: PokerMill100 folded before Flop (didn't bet)



PokerStars Game #35602658421:  Hold'em No Limit (€0.05/€0.10 EUR) - 2009/11/20 7:40:35 ET
Table 'Lampland' 6-max Seat #3 is the button
Seat 2: HomerrrJay (€12.86 in chips) 
Seat 3: andi661 (€1.13 in chips) 
Seat 4: Hero (€11.49 in chips) 
Seat 6: PokerMill100 (€3.84 in chips) 
Hero: posts small blind €0.05
PokerMill100: posts big blind €0.10
*** HOLE CARDS ***
Dealt to Hero [9s 2s]
HomerrrJay: folds 
andi661: calls €0.10
Hero: folds 
PokerMill100: checks 
*** FLOP *** [Jh Qs Js]
PokerMill100: checks 
andi661: bets €0.30
PokerMill100: folds 
Uncalled bet (€0.30) returned to andi661
andi661 collected €0.24 from pot
*** SUMMARY ***
Total pot €0.25 | Rake €0.01 
Board [Jh Qs Js]
Seat 2: HomerrrJay folded before Flop (didn't bet)
Seat 3: andi661 (button) collected (€0.24)
Seat 4: Hero (small blind) folded before Flop
Seat 6: PokerMill100 (big blind) folded on the Flop



PokerStars Game #35602664558:  Hold'em No Limit (€0.05/€0.10 EUR) - 2009/11/20 7:40:51 ET
Table 'Lampland' 6-max Seat #4 is the button
Seat 2: HomerrrJay (€12.86 in chips) 
Seat 3: andi661 (€1.27 in chips) 
Seat 4: Hero (€11.44 in chips) 
Seat 6: PokerMill100 (€3.74 in chips) 
PokerMill100: posts small blind €0.05
HomerrrJay: posts big blind €0.10
*** HOLE CARDS ***
Dealt to Hero [9h 4h]
andi661: folds 
Hero: folds 
PokerMill100: calls €0.05
HomerrrJay: checks 
*** FLOP *** [6h Qd 9s]
PokerMill100: checks 
HomerrrJay: checks 
*** TURN *** [6h Qd 9s] [6c]
PokerMill100: checks 
HomerrrJay: bets €0.20
PokerMill100: calls €0.20
*** RIVER *** [6h Qd 9s 6c] [2d]
PokerMill100: checks 
HomerrrJay: checks 
*** SHOW DOWN ***
PokerMill100: shows [6d 5h] (three of a kind, Sixes)
HomerrrJay: mucks hand 
PokerMill100 collected €0.58 from pot
*** SUMMARY ***
Total pot €0.60 | Rake €0.02 
Board [6h Qd 9s 6c 2d]
Seat 2: HomerrrJay (big blind) mucked [2s 3d]
Seat 3: andi661 folded before Flop (didn't bet)
Seat 4: Hero (button) folded before Flop (didn't bet)
Seat 6: PokerMill100 (small blind) showed [6d 5h] and won (€0.58) with three of a kind, Sixes



PokerStars Game #35602675399:  Hold'em No Limit (€0.05/€0.10 EUR) - 2009/11/20 7:41:19 ET
Table 'Lampland' 6-max Seat #6 is the button
Seat 2: HomerrrJay (€12.56 in chips) 
Seat 3: andi661 (€1.27 in chips) 
Seat 4: Hero (€11.44 in chips) 
Seat 6: PokerMill100 (€4.02 in chips) 
HomerrrJay: posts small blind €0.05
andi661: posts big blind €0.10
*** HOLE CARDS ***
Dealt to Hero [Ts Th]
Hero: raises €0.20 to €0.30
PokerMill100: folds 
HomerrrJay: raises €0.80 to €1.10
andi661: raises €0.17 to €1.27 and is all-in
Frenchmeistr joins the table at seat #5 
Hero: calls €0.97
HomerrrJay: calls €0.17
*** FLOP *** [2h 8c Qd]
HomerrrJay: checks 
Hero: checks 
*** TURN *** [2h 8c Qd] [8h]
HomerrrJay: checks 
Hero: checks 
*** RIVER *** [2h 8c Qd 8h] [Ah]
HomerrrJay: bets €2
Hero: folds 
Uncalled bet (€2) returned to HomerrrJay
*** SHOW DOWN ***
HomerrrJay: shows [Kd As] (two pair, Aces and Eights)
andi661: shows [4s 4c] (two pair, Eights and Fours)
terpoox joins the table at seat #1 
HomerrrJay collected €3.62 from pot
*** SUMMARY ***
Total pot €3.81 | Rake €0.19 
Board [2h 8c Qd 8h Ah]
Seat 2: HomerrrJay (small blind) showed [Kd As] and won (€3.62) with two pair, Aces and Eights
Seat 3: andi661 (big blind) showed [4s 4c] and lost with two pair, Eights and Fours
Seat 4: Hero folded on the River
Seat 6: PokerMill100 (button) folded before Flop (didn't bet)



PokerStars Game #35602689357:  Hold'em No Limit (€0.05/€0.10 EUR) - 2009/11/20 7:41:56 ET
Table 'Lampland' 6-max Seat #2 is the button
Seat 2: HomerrrJay (€14.91 in chips) 
Seat 4: Hero (€10.17 in chips) 
Seat 5: Frenchmeistr (€2 in chips) 
Seat 6: PokerMill100 (€4.02 in chips) 
Hero: posts small blind €0.05
Frenchmeistr: posts big blind €0.10
terpoox: sits out 
*** HOLE CARDS ***
Dealt to Hero [8h Qs]
PokerMill100: folds 
andi661 leaves the table
HomerrrJay: folds 
Hero: folds 
Uncalled bet (€0.05) returned to Frenchmeistr
Frenchmeistr collected €0.10 from pot
Frenchmeistr: doesn't show hand 
*** SUMMARY ***
Total pot €0.10 | Rake €0 
Seat 2: HomerrrJay (button) folded before Flop (didn't bet)
Seat 4: Hero (small blind) folded before Flop
Seat 5: Frenchmeistr (big blind) collected (€0.10)
Seat 6: PokerMill100 folded before Flop (didn't bet)



PokerStars Game #35602693895:  Hold'em No Limit (€0.05/€0.10 EUR) - 2009/11/20 7:42:07 ET
Table 'Lampland' 6-max Seat #4 is the button
Seat 2: HomerrrJay (€14.91 in chips) 
Seat 4: Hero (€10.12 in chips) 
Seat 5: Frenchmeistr (€2.05 in chips) 
Seat 6: PokerMill100 (€4.02 in chips) 
Frenchmeistr: posts small blind €0.05
PokerMill100: posts big blind €0.10
terpoox: sits out 
*** HOLE CARDS ***
Dealt to Hero [8s 4h]
HomerrrJay: folds 
Hero: folds 
Frenchmeistr: calls €0.05
PokerMill100: raises €0.30 to €0.40
Frenchmeistr: calls €0.30
*** FLOP *** [Js 7d Qs]
Oswood joins the table at seat #3 
Frenchmeistr: checks 
PokerMill100: bets €0.40
Frenchmeistr: folds 
Uncalled bet (€0.40) returned to PokerMill100
PokerMill100 collected €0.76 from pot
PokerMill100: doesn't show hand 
*** SUMMARY ***
Total pot €0.80 | Rake €0.04 
Board [Js 7d Qs]
Seat 2: HomerrrJay folded before Flop (didn't bet)
Seat 4: Hero (button) folded before Flop (didn't bet)
Seat 5: Frenchmeistr (small blind) folded on the Flop
Seat 6: PokerMill100 (big blind) collected (€0.76)



PokerStars Game #35602703765:  Hold'em No Limit (€0.05/€0.10 EUR) - 2009/11/20 7:42:33 ET
Table 'Lampland' 6-max Seat #5 is the button
Seat 1: terpoox (€2 in chips) 
Seat 2: HomerrrJay (€14.91 in chips) 
Seat 4: Hero (€10.12 in chips) 
Seat 5: Frenchmeistr (€1.65 in chips) 
Seat 6: PokerMill100 (€4.38 in chips) 
PokerMill100: posts small blind €0.05
terpoox: posts big blind €0.10
Oswood: sits out 
*** HOLE CARDS ***
Dealt to Hero [8s Jc]
HomerrrJay: folds 
Hero: raises €0.20 to €0.30
Frenchmeistr: raises €1.35 to €1.65 and is all-in
PokerMill100: folds 
terpoox: folds 
Hero: folds 
Uncalled bet (€1.35) returned to Frenchmeistr
Frenchmeistr collected €0.75 from pot
Frenchmeistr: doesn't show hand 
*** SUMMARY ***
Total pot €0.75 | Rake €0 
Seat 1: terpoox (big blind) folded before Flop
Seat 2: HomerrrJay folded before Flop (didn't bet)
Seat 4: Hero folded before Flop
Seat 5: Frenchmeistr (button) collected (€0.75)
Seat 6: PokerMill100 (small blind) folded before Flop



PokerStars Game #35602710852:  Hold'em No Limit (€0.05/€0.10 EUR) - 2009/11/20 7:42:51 ET
Table 'Lampland' 6-max Seat #6 is the button
Seat 1: terpoox (€1.90 in chips) 
Seat 2: HomerrrJay (€14.91 in chips) 
Seat 4: Hero (€9.82 in chips) 
Seat 5: Frenchmeistr (€2.10 in chips) 
Seat 6: PokerMill100 (€4.33 in chips) 
terpoox: posts small blind €0.05
HomerrrJay: posts big blind €0.10
Oswood: sits out 
*** HOLE CARDS ***
Dealt to Hero [As Kd]
Hero: raises €0.20 to €0.30
Frenchmeistr: calls €0.30
PokerMill100: folds 
terpoox: calls €0.25
HomerrrJay: folds 
*** FLOP *** [Tc Ts Jd]
terpoox: bets €1.60 and is all-in
Hero: folds 
Frenchmeistr: folds 
Uncalled bet (€1.60) returned to terpoox
terpoox collected €0.95 from pot
terpoox: doesn't show hand 
*** SUMMARY ***
Total pot €1 | Rake €0.05 
Board [Tc Ts Jd]
Seat 1: terpoox (small blind) collected (€0.95)
Seat 2: HomerrrJay (big blind) folded before Flop
Seat 4: Hero folded on the Flop
Seat 5: Frenchmeistr folded on the Flop
Seat 6: PokerMill100 (button) folded before Flop (didn't bet)



PokerStars Game #35602723811:  Hold'em No Limit (€0.05/€0.10 EUR) - 2009/11/20 7:43:25 ET
Table 'Lampland' 6-max Seat #1 is the button
Seat 1: terpoox (€2.55 in chips) 
Seat 2: HomerrrJay (€14.81 in chips) 
Seat 3: Oswood (€12.41 in chips) 
Seat 4: Hero (€9.52 in chips) 
Seat 5: Frenchmeistr (€1.80 in chips) 
Seat 6: PokerMill100 (€4.33 in chips) 
HomerrrJay: posts small blind €0.05
Oswood: posts big blind €0.10
*** HOLE CARDS ***
Dealt to Hero [8c 7h]
Hero: folds 
Frenchmeistr: calls €0.10
PokerMill100: calls €0.10
terpoox: folds 
HomerrrJay: folds 
Oswood: checks 
*** FLOP *** [6h 5s As]
Oswood: checks 
Frenchmeistr: checks 
PokerMill100: checks 
*** TURN *** [6h 5s As] [9c]
Oswood: checks 
Frenchmeistr: checks 
PokerMill100: bets €0.20
Oswood: calls €0.20
Frenchmeistr: calls €0.20
*** RIVER *** [6h 5s As 9c] [Ad]
Oswood: checks 
Frenchmeistr: checks 
PokerMill100: checks 
*** SHOW DOWN ***
Oswood: shows [7s 5h] (two pair, Aces and Fives)
Frenchmeistr: mucks hand 
PokerMill100: shows [9d Kd] (two pair, Aces and Nines)
PokerMill100 collected €0.91 from pot
*** SUMMARY ***
Total pot €0.95 | Rake €0.04 
Board [6h 5s As 9c Ad]
Seat 1: terpoox (button) folded before Flop (didn't bet)
Seat 2: HomerrrJay (small blind) folded before Flop
Seat 3: Oswood (big blind) showed [7s 5h] and lost with two pair, Aces and Fives
Seat 4: Hero folded before Flop (didn't bet)
Seat 5: Frenchmeistr mucked [2h 3d]
Seat 6: PokerMill100 showed [9d Kd] and won (€0.91) with two pair, Aces and Nines



PokerStars Game #35602741546:  Hold'em No Limit (€0.05/€0.10 EUR) - 2009/11/20 7:44:11 ET
Table 'Lampland' 6-max Seat #2 is the button
Seat 1: terpoox (€2.55 in chips) 
Seat 2: HomerrrJay (€14.76 in chips) 
Seat 3: Oswood (€12.11 in chips) 
Seat 4: Hero (€9.52 in chips) 
Seat 5: Frenchmeistr (€1.50 in chips) 
Seat 6: PokerMill100 (€4.94 in chips) 
Oswood: posts small blind €0.05
Hero: posts big blind €0.10
*** HOLE CARDS ***
Dealt to Hero [Jd 3d]
Frenchmeistr: calls €0.10
PokerMill100: raises €0.30 to €0.40
terpoox: folds 
HomerrrJay: calls €0.40
Oswood: calls €0.35
Hero: folds 
Frenchmeistr: calls €0.30
*** FLOP *** [6d 3c 4d]
Oswood: checks 
Frenchmeistr: bets €1.10 and is all-in
PokerMill100: folds 
HomerrrJay: raises €1.30 to €2.40
Oswood: folds 
Uncalled bet (€1.30) returned to HomerrrJay
*** TURN *** [6d 3c 4d] [7h]
*** RIVER *** [6d 3c 4d 7h] [Th]
*** SHOW DOWN ***
Frenchmeistr: shows [5h Qc] (a straight, Three to Seven)
HomerrrJay: shows [9c 9s] (a pair of Nines)
Frenchmeistr collected €3.71 from pot
*** SUMMARY ***
Total pot €3.90 | Rake €0.19 
Board [6d 3c 4d 7h Th]
Seat 1: terpoox folded before Flop (didn't bet)
Seat 2: HomerrrJay (button) showed [9c 9s] and lost with a pair of Nines
Seat 3: Oswood (small blind) folded on the Flop
Seat 4: Hero (big blind) folded before Flop
Seat 5: Frenchmeistr showed [5h Qc] and won (€3.71) with a straight, Three to Seven
Seat 6: PokerMill100 folded on the Flop



PokerStars Game #35602758193:  Hold'em No Limit (€0.05/€0.10 EUR) - 2009/11/20 7:44:54 ET
Table 'Lampland' 6-max Seat #3 is the button
Seat 1: terpoox (€2.55 in chips) 
Seat 2: HomerrrJay (€13.26 in chips) 
Seat 3: Oswood (€11.71 in chips) 
Seat 4: Hero (€9.42 in chips) 
Seat 5: Frenchmeistr (€3.71 in chips) 
Seat 6: PokerMill100 (€4.54 in chips) 
Hero: posts small blind €0.05
Frenchmeistr: posts big blind €0.10
*** HOLE CARDS ***
Dealt to Hero [4d Jh]
PokerMill100: folds 
terpoox: raises €0.20 to €0.30
HomerrrJay: raises €0.80 to €1.10
Oswood: folds 
Hero: folds 
Frenchmeistr: folds 
terpoox: folds 
Uncalled bet (€0.80) returned to HomerrrJay
HomerrrJay collected €0.75 from pot
HomerrrJay: doesn't show hand 
*** SUMMARY ***
Total pot €0.75 | Rake €0 
Seat 1: terpoox folded before Flop
Seat 2: HomerrrJay collected (€0.75)
Seat 3: Oswood (button) folded before Flop (didn't bet)
Seat 4: Hero (small blind) folded before Flop
Seat 5: Frenchmeistr (big blind) folded before Flop
Seat 6: PokerMill100 folded before Flop (didn't bet)



PokerStars Game #35602766776:  Hold'em No Limit (€0.05/€0.10 EUR) - 2009/11/20 7:45:17 ET
Table 'Lampland' 6-max Seat #4 is the button
Seat 1: terpoox (€2.25 in chips) 
Seat 2: HomerrrJay (€13.71 in chips) 
Seat 3: Oswood (€11.71 in chips) 
Seat 4: Hero (€9.37 in chips) 
Seat 5: Frenchmeistr (€3.61 in chips) 
Seat 6: PokerMill100 (€4.54 in chips) 
Frenchmeistr: posts small blind €0.05
PokerMill100: posts big blind €0.10
*** HOLE CARDS ***
Dealt to Hero [5d 9h]
terpoox: calls €0.10
HomerrrJay: raises €0.40 to €0.50
Oswood: calls €0.50
Hero: folds 
Frenchmeistr: folds 
PokerMill100: calls €0.40
terpoox: calls €0.40
*** FLOP *** [Qh As 9d]
PokerMill100: checks 
terpoox: checks 
HomerrrJay: checks 
Oswood: checks 
*** TURN *** [Qh As 9d] [8d]
PokerMill100: checks 
terpoox: bets €1.75 and is all-in
HomerrrJay: folds 
Oswood: calls €1.75
PokerMill100: folds 
*** RIVER *** [Qh As 9d 8d] [3h]
*** SHOW DOWN ***
terpoox: shows [Ac 4c] (a pair of Aces)
Oswood: shows [Js Ts] (a straight, Eight to Queen)
Oswood collected €5.28 from pot
*** SUMMARY ***
Total pot €5.55 | Rake €0.27 
Board [Qh As 9d 8d 3h]
Seat 1: terpoox showed [Ac 4c] and lost with a pair of Aces
Seat 2: HomerrrJay folded on the Turn
Seat 3: Oswood showed [Js Ts] and won (€5.28) with a straight, Eight to Queen
Seat 4: Hero (button) folded before Flop (didn't bet)
Seat 5: Frenchmeistr (small blind) folded before Flop
Seat 6: PokerMill100 (big blind) folded on the Turn



PokerStars Game #35602783606:  Hold'em No Limit (€0.05/€0.10 EUR) - 2009/11/20 7:46:00 ET
Table 'Lampland' 6-max Seat #5 is the button
Seat 2: HomerrrJay (€13.21 in chips) 
Seat 3: Oswood (€14.74 in chips) 
Seat 4: Hero (€9.37 in chips) 
Seat 5: Frenchmeistr (€3.56 in chips) 
Seat 6: PokerMill100 (€4.04 in chips) 
PokerMill100: posts small blind €0.05
HomerrrJay: posts big blind €0.10
*** HOLE CARDS ***
Dealt to Hero [7s Kh]
Oswood: raises €0.20 to €0.30
Hero: folds 
Frenchmeistr: calls €0.30
PokerMill100: calls €0.25
HomerrrJay: folds 
*** FLOP *** [5h 3c 6s]
PokerMill100: checks 
Oswood: checks 
Frenchmeistr: bets €3.26 and is all-in
PokerMill100: raises €0.48 to €3.74 and is all-in
terpoox leaves the table
Oswood: folds 
Uncalled bet (€0.48) returned to PokerMill100
*** TURN *** [5h 3c 6s] [Qs]
*** RIVER *** [5h 3c 6s Qs] [2s]
*** SHOW DOWN ***
PokerMill100: shows [6d 3d] (two pair, Sixes and Threes)
Frenchmeistr: shows [9d 6h] (a pair of Sixes)
PokerMill100 collected €7.15 from pot
*** SUMMARY ***
Total pot €7.52 | Rake €0.37 
Board [5h 3c 6s Qs 2s]
Seat 2: HomerrrJay (big blind) folded before Flop
Seat 3: Oswood folded on the Flop
Seat 4: Hero folded before Flop (didn't bet)
Seat 5: Frenchmeistr (button) showed [9d 6h] and lost with a pair of Sixes
Seat 6: PokerMill100 (small blind) showed [6d 3d] and won (€7.15) with two pair, Sixes and Threes



PokerStars Game #35602802439:  Hold'em No Limit (€0.05/€0.10 EUR) - 2009/11/20 7:46:48 ET
Table 'Lampland' 6-max Seat #6 is the button
Seat 2: HomerrrJay (€13.11 in chips) 
Seat 3: Oswood (€14.44 in chips) 
Seat 4: Hero (€9.37 in chips) 
Seat 6: PokerMill100 (€7.63 in chips) 
HomerrrJay: posts small blind €0.05
Oswood: posts big blind €0.10
*** HOLE CARDS ***
Dealt to Hero [9s Qc]
Hero: folds 
PokerMill100: folds 
HomerrrJay: folds 
Uncalled bet (€0.05) returned to Oswood
Frenchmeistr leaves the table
Oswood collected €0.10 from pot
*** SUMMARY ***
Total pot €0.10 | Rake €0 
Seat 2: HomerrrJay (small blind) folded before Flop
Seat 3: Oswood (big blind) collected (€0.10)
Seat 4: Hero folded before Flop (didn't bet)
Seat 6: PokerMill100 (button) folded before Flop (didn't bet)



PokerStars Game #35602807096:  Hold'em No Limit (€0.05/€0.10 EUR) - 2009/11/20 7:47:00 ET
Table 'Lampland' 6-max Seat #2 is the button
Seat 2: HomerrrJay (€13.06 in chips) 
Seat 3: Oswood (€14.49 in chips) 
Seat 4: Hero (€9.37 in chips) 
Seat 6: PokerMill100 (€7.63 in chips) 
Oswood: posts small blind €0.05
Hero: posts big blind €0.10
*** HOLE CARDS ***
Dealt to Hero [7d 9h]
PokerMill100: folds 
smokin_hot08 joins the table at seat #1 
HomerrrJay: folds 
Oswood: calls €0.05
Hero: checks 
*** FLOP *** [2h Ts Th]
Oswood: checks 
Hero: checks 
*** TURN *** [2h Ts Th] [2d]
Oswood: checks 
Hero: checks 
*** RIVER *** [2h Ts Th 2d] [As]
Oswood: checks 
Hero: checks 
*** SHOW DOWN ***
Oswood: shows [5s Qs] (two pair, Tens and Deuces)
Hero: shows [7d 9h] (two pair, Tens and Deuces)
Oswood collected €0.10 from pot
Hero collected €0.09 from pot
*** SUMMARY ***
Total pot €0.20 | Rake €0.01 
Board [2h Ts Th 2d As]
Seat 2: HomerrrJay (button) folded before Flop (didn't bet)
Seat 3: Oswood (small blind) showed [5s Qs] and won (€0.10) with two pair, Tens and Deuces
Seat 4: Hero (big blind) showed [7d 9h] and won (€0.09) with two pair, Tens and Deuces
Seat 6: PokerMill100 folded before Flop (didn't bet)



PokerStars Game #35602819421:  Hold'em No Limit (€0.05/€0.10 EUR) - 2009/11/20 7:47:32 ET
Table 'Lampland' 6-max Seat #3 is the button
Seat 1: smokin_hot08 (€2 in chips) 
Seat 2: HomerrrJay (€13.06 in chips) 
Seat 3: Oswood (€14.49 in chips) 
Seat 4: Hero (€9.36 in chips) 
Seat 6: PokerMill100 (€7.63 in chips) 
Hero: posts small blind €0.05
PokerMill100: posts big blind €0.10
smokin_hot08: posts big blind €0.10
*** HOLE CARDS ***
Dealt to Hero [5c 8d]
smokin_hot08: raises €0.50 to €0.60
HomerrrJay: folds 
Oswood: folds 
Hero: folds 
PokerMill100: calls €0.50
*** FLOP *** [Th Qh 2h]
PokerMill100: checks 
smokin_hot08: bets €1.40 and is all-in
PokerMill100: calls €1.40
*** TURN *** [Th Qh 2h] [3h]
*** RIVER *** [Th Qh 2h 3h] [Td]
*** SHOW DOWN ***
PokerMill100: shows [Ah Jc] (a flush, Ace high)
smokin_hot08: shows [9c 9d] (two pair, Tens and Nines)
PokerMill100 collected €3.86 from pot
*** SUMMARY ***
Total pot €4.05 | Rake €0.19 
Board [Th Qh 2h 3h Td]
Seat 1: smokin_hot08 showed [9c 9d] and lost with two pair, Tens and Nines
Seat 2: HomerrrJay folded before Flop (didn't bet)
Seat 3: Oswood (button) folded before Flop (didn't bet)
Seat 4: Hero (small blind) folded before Flop
Seat 6: PokerMill100 (big blind) showed [Ah Jc] and won (€3.86) with a flush, Ace high



PokerStars Game #35602834956:  Hold'em No Limit (€0.05/€0.10 EUR) - 2009/11/20 7:48:12 ET
Table 'Lampland' 6-max Seat #4 is the button
Seat 2: HomerrrJay (€13.06 in chips) 
Seat 3: Oswood (€14.49 in chips) 
Seat 4: Hero (€9.31 in chips) 
Seat 6: PokerMill100 (€9.49 in chips) 
PokerMill100: posts small blind €0.05
HomerrrJay: posts big blind €0.10
*** HOLE CARDS ***
Dealt to Hero [4s 5d]
smokin_hot08 leaves the table
Oswood: folds 
Hero: folds 
PokerMill100: calls €0.05
HomerrrJay: checks 
*** FLOP *** [Kh 7d Jc]
PokerMill100: checks 
HomerrrJay: checks 
*** TURN *** [Kh 7d Jc] [9h]
PokerMill100: checks 
HomerrrJay: checks 
*** RIVER *** [Kh 7d Jc 9h] [Kd]
PokerMill100: checks 
HomerrrJay: checks 
*** SHOW DOWN ***
PokerMill100: shows [5s 6d] (a pair of Kings)
HomerrrJay: shows [2h As] (a pair of Kings - Ace kicker)
PokerMill100 is sitting out
HomerrrJay collected €0.19 from pot
*** SUMMARY ***
Total pot €0.20 | Rake €0.01 
Board [Kh 7d Jc 9h Kd]
Seat 2: HomerrrJay (big blind) showed [2h As] and won (€0.19) with a pair of Kings
Seat 3: Oswood folded before Flop (didn't bet)
Seat 4: Hero (button) folded before Flop (didn't bet)
Seat 6: PokerMill100 (small blind) showed [5s 6d] and lost with a pair of Kings



PokerStars Game #35602844425:  Hold'em No Limit (€0.05/€0.10 EUR) - 2009/11/20 7:48:37 ET
Table 'Lampland' 6-max Seat #2 is the button
Seat 2: HomerrrJay (€13.15 in chips) 
Seat 3: Oswood (€14.49 in chips) 
Seat 4: Hero (€9.31 in chips) 
PokerMill100 leaves the table
Oswood: posts small blind €0.05
Hero: posts big blind €0.10
*** HOLE CARDS ***
Dealt to Hero [9s Jd]
HomerrrJay: folds 
Oswood: folds 
Uncalled bet (€0.05) returned to Hero
Hero collected €0.10 from pot
*** SUMMARY ***
Total pot €0.10 | Rake €0 
Seat 2: HomerrrJay (button) folded before Flop (didn't bet)
Seat 3: Oswood (small blind) folded before Flop
Seat 4: Hero (big blind) collected (€0.10)



PokerStars Game #35602847618:  Hold'em No Limit (€0.05/€0.10 EUR) - 2009/11/20 7:48:46 ET
Table 'Lampland' 6-max Seat #3 is the button
Seat 2: HomerrrJay (€13.15 in chips) 
Seat 3: Oswood (€14.44 in chips) 
Seat 4: Hero (€9.36 in chips) 
Hero: posts small blind €0.05
HomerrrJay: posts big blind €0.10
*** HOLE CARDS ***
Dealt to Hero [Ad Th]
Oswood: folds 
Oswood leaves the table
Hero: raises €0.20 to €0.30
HomerrrJay: folds 
Uncalled bet (€0.20) returned to Hero
Hero collected €0.20 from pot
*** SUMMARY ***
Total pot €0.20 | Rake €0 
Seat 2: HomerrrJay (big blind) folded before Flop
Seat 3: Oswood (button) folded before Flop (didn't bet)
Seat 4: Hero (small blind) collected (€0.20)



PokerStars Game #35602851942:  Hold'em No Limit (€0.05/€0.10 EUR) - 2009/11/20 7:48:57 ET
Table 'Lampland' 6-max Seat #2 is the button
Seat 2: HomerrrJay (€13.05 in chips) 
Seat 4: Hero (€9.46 in chips) 
HomerrrJay: posts small blind €0.05
Hero: posts big blind €0.10
*** HOLE CARDS ***
Dealt to Hero [4s Qd]
HomerrrJay: raises €0.20 to €0.30
Hero: folds 
Uncalled bet (€0.20) returned to HomerrrJay
HomerrrJay collected €0.20 from pot
HomerrrJay: doesn't show hand 
*** SUMMARY ***
Total pot €0.20 | Rake €0 
Seat 2: HomerrrJay (button) (small blind) collected (€0.20)
Seat 4: Hero (big blind) folded before Flop



PokerStars Game #35602855141:  Hold'em No Limit (€0.05/€0.10 EUR) - 2009/11/20 7:49:05 ET
Table 'Lampland' 6-max Seat #4 is the button
Seat 2: HomerrrJay (€13.15 in chips) 
Seat 4: Hero (€9.36 in chips) 
Hero: posts small blind €0.05
HomerrrJay: posts big blind €0.10
*** HOLE CARDS ***
Dealt to Hero [Ad 8d]
Hero: raises €0.20 to €0.30
HomerrrJay: folds 
Uncalled bet (€0.20) returned to Hero
HomerrrJay leaves the table
Hero collected €0.20 from pot
*** SUMMARY ***
Total pot €0.20 | Rake €0 
Seat 2: HomerrrJay (big blind) folded before Flop
Seat 4: Hero (button) (small blind) collected (€0.20)



