PokerStars Game #35824118297:  Hold'em No Limit ($0.05/$0.10 USD) - 2009/11/25 6:21:05 ET
Table 'May IV' 6-max Seat #3 is the button
Seat 1: Gles65 ($9.60 in chips) 
Seat 3: Pho3nix.two ($6.60 in chips) 
Seat 4: k1tt9nM1nd ($10 in chips) 
Seat 6: Hero ($10 in chips) 
k1tt9nM1nd: posts small blind $0.05
Hero: posts big blind $0.10
*** HOLE CARDS ***
Dealt to Hero [4c 8h]
shaunsaville joins the table at seat #2 
Gles65: folds 
Pho3nix.two: folds 
k1tt9nM1nd: raises $0.20 to $0.30
Hero: folds 
Uncalled bet ($0.20) returned to k1tt9nM1nd
k1tt9nM1nd collected $0.20 from pot
*** SUMMARY ***
Total pot $0.20 | Rake $0 
Seat 1: Gles65 folded before Flop (didn't bet)
Seat 3: Pho3nix.two (button) folded before Flop (didn't bet)
Seat 4: k1tt9nM1nd (small blind) collected ($0.20)
Seat 6: Hero (big blind) folded before Flop



PokerStars Game #35824123646:  Hold'em No Limit ($0.05/$0.10 USD) - 2009/11/25 6:21:20 ET
Table 'May IV' 6-max Seat #4 is the button
Seat 1: Gles65 ($9.60 in chips) 
Seat 2: shaunsaville ($2.65 in chips) 
Seat 3: Pho3nix.two ($6.60 in chips) 
Seat 4: k1tt9nM1nd ($10.10 in chips) 
Seat 6: Hero ($9.90 in chips) 
Hero: posts small blind $0.05
Gles65: posts big blind $0.10
shaunsaville: posts big blind $0.10
*** HOLE CARDS ***
Dealt to Hero [9s 6h]
shaunsaville: checks 
Pho3nix.two: calls $0.10
k1tt9nM1nd: folds 
Hero: folds 
Gles65: checks 
*** FLOP *** [Jh 2c Qc]
Gles65: checks 
shaunsaville: checks 
Pho3nix.two: bets $0.30
Gles65: folds 
shaunsaville: folds 
Uncalled bet ($0.30) returned to Pho3nix.two
Pho3nix.two collected $0.35 from pot
Pho3nix.two: doesn't show hand 
*** SUMMARY ***
Total pot $0.35 | Rake $0 
Board [Jh 2c Qc]
Seat 1: Gles65 (big blind) folded on the Flop
Seat 2: shaunsaville folded on the Flop
Seat 3: Pho3nix.two collected ($0.35)
Seat 4: k1tt9nM1nd (button) folded before Flop (didn't bet)
Seat 6: Hero (small blind) folded before Flop



PokerStars Game #35824134431:  Hold'em No Limit ($0.05/$0.10 USD) - 2009/11/25 6:21:51 ET
Table 'May IV' 6-max Seat #6 is the button
Seat 1: Gles65 ($9.50 in chips) 
Seat 2: shaunsaville ($2.55 in chips) 
Seat 3: Pho3nix.two ($6.85 in chips) 
Seat 4: k1tt9nM1nd ($10.10 in chips) 
Seat 6: Hero ($9.85 in chips) 
Gles65: posts small blind $0.05
shaunsaville: posts big blind $0.10
*** HOLE CARDS ***
Dealt to Hero [7h 3s]
Pho3nix.two: calls $0.10
DSOR65 joins the table at seat #5 
k1tt9nM1nd: folds 
Hero: folds 
Gles65: folds 
shaunsaville: checks 
*** FLOP *** [3h 9s Th]
shaunsaville: checks 
Pho3nix.two: checks 
*** TURN *** [3h 9s Th] [8c]
shaunsaville: checks 
Pho3nix.two: checks 
*** RIVER *** [3h 9s Th 8c] [7d]
shaunsaville: checks 
Pho3nix.two: bets $0.40
shaunsaville: folds 
Uncalled bet ($0.40) returned to Pho3nix.two
Pho3nix.two collected $0.25 from pot
*** SUMMARY ***
Total pot $0.25 | Rake $0 
Board [3h 9s Th 8c 7d]
Seat 1: Gles65 (small blind) folded before Flop
Seat 2: shaunsaville (big blind) folded on the River
Seat 3: Pho3nix.two collected ($0.25)
Seat 4: k1tt9nM1nd folded before Flop (didn't bet)
Seat 6: Hero (button) folded before Flop (didn't bet)



PokerStars Game #35824150484:  Hold'em No Limit ($0.05/$0.10 USD) - 2009/11/25 6:22:38 ET
Table 'May IV' 6-max Seat #1 is the button
Seat 1: Gles65 ($9.45 in chips) 
Seat 2: shaunsaville ($2.45 in chips) 
Seat 3: Pho3nix.two ($7 in chips) 
Seat 4: k1tt9nM1nd ($10.10 in chips) 
Seat 5: DSOR65 ($6 in chips) 
Seat 6: Hero ($9.85 in chips) 
shaunsaville: posts small blind $0.05
Pho3nix.two: posts big blind $0.10
DSOR65: posts big blind $0.10
*** HOLE CARDS ***
Dealt to Hero [9d 3c]
k1tt9nM1nd: raises $0.30 to $0.40
DSOR65: calls $0.30
Hero: folds 
Gles65: folds 
shaunsaville: raises $2.05 to $2.45 and is all-in
Pho3nix.two: folds 
k1tt9nM1nd: folds 
DSOR65: calls $2.05
*** FLOP *** [2h Ac Qd]
*** TURN *** [2h Ac Qd] [4c]
*** RIVER *** [2h Ac Qd 4c] [Js]
*** SHOW DOWN ***
shaunsaville: shows [5d 5s] (a pair of Fives)
DSOR65: shows [Jd Qs] (two pair, Queens and Jacks)
DSOR65 collected $5.15 from pot
*** SUMMARY ***
Total pot $5.40 | Rake $0.25 
Board [2h Ac Qd 4c Js]
Seat 1: Gles65 (button) folded before Flop (didn't bet)
Seat 2: shaunsaville (small blind) showed [5d 5s] and lost with a pair of Fives
Seat 3: Pho3nix.two (big blind) folded before Flop
Seat 4: k1tt9nM1nd folded before Flop
Seat 5: DSOR65 showed [Jd Qs] and won ($5.15) with two pair, Queens and Jacks
Seat 6: Hero folded before Flop (didn't bet)



PokerStars Game #35824166461:  Hold'em No Limit ($0.05/$0.10 USD) - 2009/11/25 6:23:24 ET
Table 'May IV' 6-max Seat #3 is the button
Seat 1: Gles65 ($9.45 in chips) 
Seat 3: Pho3nix.two ($6.90 in chips) 
Seat 4: k1tt9nM1nd ($10 in chips) 
Seat 5: DSOR65 ($8.70 in chips) 
Seat 6: Hero ($9.85 in chips) 
k1tt9nM1nd: posts small blind $0.05
DSOR65: posts big blind $0.10
*** HOLE CARDS ***
Dealt to Hero [5h Ts]
Hero: folds 
shaunsaville leaves the table
Gles65: folds 
Pho3nix.two: folds 
k1tt9nM1nd: raises $0.20 to $0.30
DSOR65: calls $0.20
*** FLOP *** [2c Ac Th]
k1tt9nM1nd: bets $0.45
DSOR65: folds 
Uncalled bet ($0.45) returned to k1tt9nM1nd
k1tt9nM1nd collected $0.60 from pot
*** SUMMARY ***
Total pot $0.60 | Rake $0 
Board [2c Ac Th]
Seat 1: Gles65 folded before Flop (didn't bet)
Seat 3: Pho3nix.two (button) folded before Flop (didn't bet)
Seat 4: k1tt9nM1nd (small blind) collected ($0.60)
Seat 5: DSOR65 (big blind) folded on the Flop
Seat 6: Hero folded before Flop (didn't bet)



PokerStars Game #35824176267:  Hold'em No Limit ($0.05/$0.10 USD) - 2009/11/25 6:23:53 ET
Table 'May IV' 6-max Seat #4 is the button
Seat 1: Gles65 ($9.45 in chips) 
Seat 3: Pho3nix.two ($6.90 in chips) 
Seat 4: k1tt9nM1nd ($10.30 in chips) 
Seat 5: DSOR65 ($8.40 in chips) 
Seat 6: Hero ($9.85 in chips) 
DSOR65: posts small blind $0.05
Hero: posts big blind $0.10
*** HOLE CARDS ***
Dealt to Hero [3d 3h]
Gles65: folds 
Pho3nix.two: raises $0.20 to $0.30
k1tt9nM1nd: folds 
DSOR65: calls $0.25
Hero: calls $0.20
*** FLOP *** [9d 9h 2d]
DSOR65: checks 
Hero: checks 
Pho3nix.two: bets $0.40
DSOR65: folds 
Hero: calls $0.40
*** TURN *** [9d 9h 2d] [8d]
Hero: checks 
Dragsta03 joins the table at seat #2 
Pho3nix.two: bets $0.80
Hero: calls $0.80
*** RIVER *** [9d 9h 2d 8d] [Js]
Hero: checks 
Pho3nix.two: bets $1
Hero: calls $1
*** SHOW DOWN ***
Pho3nix.two: shows [Ac As] (two pair, Aces and Nines)
Hero: mucks hand 
Pho3nix.two collected $5.05 from pot
*** SUMMARY ***
Total pot $5.30 | Rake $0.25 
Board [9d 9h 2d 8d Js]
Seat 1: Gles65 folded before Flop (didn't bet)
Seat 3: Pho3nix.two showed [Ac As] and won ($5.05) with two pair, Aces and Nines
Seat 4: k1tt9nM1nd (button) folded before Flop (didn't bet)
Seat 5: DSOR65 (small blind) folded on the Flop
Seat 6: Hero (big blind) mucked [3d 3h]



PokerStars Game #35824195938:  Hold'em No Limit ($0.05/$0.10 USD) - 2009/11/25 6:24:51 ET
Table 'May IV' 6-max Seat #5 is the button
Seat 1: Gles65 ($9.45 in chips) 
Seat 2: Dragsta03 ($4 in chips) 
Seat 3: Pho3nix.two ($9.45 in chips) 
Seat 4: k1tt9nM1nd ($10.30 in chips) 
Seat 5: DSOR65 ($8.10 in chips) 
Seat 6: Hero ($7.35 in chips) 
Hero: posts small blind $0.05
Gles65: posts big blind $0.10
Dragsta03: posts big blind $0.10
*** HOLE CARDS ***
Dealt to Hero [Jd Qs]
Dragsta03: checks 
Pho3nix.two: calls $0.10
k1tt9nM1nd: raises $0.50 to $0.60
DSOR65: folds 
Hero: folds 
Gles65: folds 
Dragsta03: folds 
Pho3nix.two: folds 
Uncalled bet ($0.50) returned to k1tt9nM1nd
k1tt9nM1nd collected $0.45 from pot
*** SUMMARY ***
Total pot $0.45 | Rake $0 
Seat 1: Gles65 (big blind) folded before Flop
Seat 2: Dragsta03 folded before Flop
Seat 3: Pho3nix.two folded before Flop
Seat 4: k1tt9nM1nd collected ($0.45)
Seat 5: DSOR65 (button) folded before Flop (didn't bet)
Seat 6: Hero (small blind) folded before Flop



PokerStars Game #35824204799:  Hold'em No Limit ($0.05/$0.10 USD) - 2009/11/25 6:25:17 ET
Table 'May IV' 6-max Seat #6 is the button
Seat 1: Gles65 ($9.35 in chips) 
Seat 2: Dragsta03 ($3.90 in chips) 
Seat 3: Pho3nix.two ($9.35 in chips) 
Seat 4: k1tt9nM1nd ($10.65 in chips) 
Seat 5: DSOR65 ($8.10 in chips) 
Seat 6: Hero ($7.30 in chips) 
Gles65: posts small blind $0.05
Dragsta03: posts big blind $0.10
*** HOLE CARDS ***
Dealt to Hero [9c 8h]
Pho3nix.two: folds 
k1tt9nM1nd: folds 
DSOR65: calls $0.10
Hero: folds 
Gles65: folds 
Dragsta03: checks 
*** FLOP *** [Ac Qd 7s]
Dragsta03: checks 
DSOR65: checks 
*** TURN *** [Ac Qd 7s] [4d]
Dragsta03: checks 
DSOR65: bets $0.10
Dragsta03: folds 
Uncalled bet ($0.10) returned to DSOR65
DSOR65 collected $0.25 from pot
*** SUMMARY ***
Total pot $0.25 | Rake $0 
Board [Ac Qd 7s 4d]
Seat 1: Gles65 (small blind) folded before Flop
Seat 2: Dragsta03 (big blind) folded on the Turn
Seat 3: Pho3nix.two folded before Flop (didn't bet)
Seat 4: k1tt9nM1nd folded before Flop (didn't bet)
Seat 5: DSOR65 collected ($0.25)
Seat 6: Hero (button) folded before Flop (didn't bet)



PokerStars Game #35824214441:  Hold'em No Limit ($0.05/$0.10 USD) - 2009/11/25 6:25:46 ET
Table 'May IV' 6-max Seat #1 is the button
Seat 1: Gles65 ($9.30 in chips) 
Seat 2: Dragsta03 ($3.80 in chips) 
Seat 3: Pho3nix.two ($9.35 in chips) 
Seat 4: k1tt9nM1nd ($10.65 in chips) 
Seat 5: DSOR65 ($8.25 in chips) 
Seat 6: Hero ($7.30 in chips) 
Dragsta03: posts small blind $0.05
Pho3nix.two: posts big blind $0.10
*** HOLE CARDS ***
Dealt to Hero [3d 6h]
k1tt9nM1nd: folds 
DSOR65: folds 
Hero: folds 
Gles65: folds 
Dragsta03: calls $0.05
Pho3nix.two: checks 
*** FLOP *** [Tc 2c 5h]
Dragsta03: checks 
Pho3nix.two: checks 
*** TURN *** [Tc 2c 5h] [Qh]
Dragsta03: checks 
Pho3nix.two: checks 
*** RIVER *** [Tc 2c 5h Qh] [8d]
Dragsta03: checks 
Pho3nix.two: checks 
*** SHOW DOWN ***
Dragsta03: shows [7s Ah] (high card Ace)
Pho3nix.two: mucks hand 
Dragsta03 collected $0.20 from pot
*** SUMMARY ***
Total pot $0.20 | Rake $0 
Board [Tc 2c 5h Qh 8d]
Seat 1: Gles65 (button) folded before Flop (didn't bet)
Seat 2: Dragsta03 (small blind) showed [7s Ah] and won ($0.20) with high card Ace
Seat 3: Pho3nix.two (big blind) mucked [7c 3h]
Seat 4: k1tt9nM1nd folded before Flop (didn't bet)
Seat 5: DSOR65 folded before Flop (didn't bet)
Seat 6: Hero folded before Flop (didn't bet)



PokerStars Game #35824225047:  Hold'em No Limit ($0.05/$0.10 USD) - 2009/11/25 6:26:17 ET
Table 'May IV' 6-max Seat #2 is the button
Seat 1: Gles65 ($9.30 in chips) 
Seat 2: Dragsta03 ($3.90 in chips) 
Seat 3: Pho3nix.two ($9.25 in chips) 
Seat 4: k1tt9nM1nd ($10.65 in chips) 
Seat 5: DSOR65 ($8.25 in chips) 
Seat 6: Hero ($7.30 in chips) 
Pho3nix.two: posts small blind $0.05
k1tt9nM1nd: posts big blind $0.10
*** HOLE CARDS ***
Dealt to Hero [Ah 4h]
DSOR65: folds 
Hero: raises $0.20 to $0.30
Gles65: folds 
Dragsta03: folds 
Pho3nix.two: folds 
k1tt9nM1nd: folds 
Uncalled bet ($0.20) returned to Hero
Hero collected $0.25 from pot
*** SUMMARY ***
Total pot $0.25 | Rake $0 
Seat 1: Gles65 folded before Flop (didn't bet)
Seat 2: Dragsta03 (button) folded before Flop (didn't bet)
Seat 3: Pho3nix.two (small blind) folded before Flop
Seat 4: k1tt9nM1nd (big blind) folded before Flop
Seat 5: DSOR65 folded before Flop (didn't bet)
Seat 6: Hero collected ($0.25)



PokerStars Game #35824234443:  Hold'em No Limit ($0.05/$0.10 USD) - 2009/11/25 6:26:44 ET
Table 'May IV' 6-max Seat #3 is the button
Seat 1: Gles65 ($9.30 in chips) 
Seat 2: Dragsta03 ($3.90 in chips) 
Seat 3: Pho3nix.two ($9.20 in chips) 
Seat 4: k1tt9nM1nd ($10.55 in chips) 
Seat 5: DSOR65 ($8.25 in chips) 
Seat 6: Hero ($7.45 in chips) 
k1tt9nM1nd: posts small blind $0.05
DSOR65: posts big blind $0.10
*** HOLE CARDS ***
Dealt to Hero [9s Ac]
Hero: folds 
Gles65: folds 
Dragsta03: folds 
Pho3nix.two: raises $0.20 to $0.30
k1tt9nM1nd: raises $0.90 to $1.20
DSOR65: folds 
Pho3nix.two: folds 
Uncalled bet ($0.90) returned to k1tt9nM1nd
k1tt9nM1nd collected $0.70 from pot
*** SUMMARY ***
Total pot $0.70 | Rake $0 
Seat 1: Gles65 folded before Flop (didn't bet)
Seat 2: Dragsta03 folded before Flop (didn't bet)
Seat 3: Pho3nix.two (button) folded before Flop
Seat 4: k1tt9nM1nd (small blind) collected ($0.70)
Seat 5: DSOR65 (big blind) folded before Flop
Seat 6: Hero folded before Flop (didn't bet)



PokerStars Game #35824248670:  Hold'em No Limit ($0.05/$0.10 USD) - 2009/11/25 6:27:26 ET
Table 'May IV' 6-max Seat #4 is the button
Seat 1: Gles65 ($9.30 in chips) 
Seat 2: Dragsta03 ($3.90 in chips) 
Seat 3: Pho3nix.two ($8.90 in chips) 
Seat 4: k1tt9nM1nd ($10.95 in chips) 
Seat 5: DSOR65 ($8.15 in chips) 
Seat 6: Hero ($7.45 in chips) 
DSOR65: posts small blind $0.05
Hero: posts big blind $0.10
*** HOLE CARDS ***
Dealt to Hero [6s 2c]
Gles65: folds 
Dragsta03: folds 
Pho3nix.two: folds 
Pho3nix.two is sitting out
k1tt9nM1nd: folds 
DSOR65: calls $0.05
Hero: checks 
*** FLOP *** [Kc 2h 7s]
DSOR65: checks 
Hero: bets $0.20
DSOR65: calls $0.20
*** TURN *** [Kc 2h 7s] [5h]
DSOR65: checks 
Hero: checks 
*** RIVER *** [Kc 2h 7s 5h] [8c]
DSOR65: bets $0.70
Hero: calls $0.70
*** SHOW DOWN ***
DSOR65: shows [6c Kd] (a pair of Kings)
Hero: mucks hand 
DSOR65 collected $1.90 from pot
*** SUMMARY ***
Total pot $2 | Rake $0.10 
Board [Kc 2h 7s 5h 8c]
Seat 1: Gles65 folded before Flop (didn't bet)
Seat 2: Dragsta03 folded before Flop (didn't bet)
Seat 3: Pho3nix.two folded before Flop (didn't bet)
Seat 4: k1tt9nM1nd (button) folded before Flop (didn't bet)
Seat 5: DSOR65 (small blind) showed [6c Kd] and won ($1.90) with a pair of Kings
Seat 6: Hero (big blind) mucked [6s 2c]



PokerStars Game #35824262964:  Hold'em No Limit ($0.05/$0.10 USD) - 2009/11/25 6:28:08 ET
Table 'May IV' 6-max Seat #5 is the button
Seat 1: Gles65 ($9.30 in chips) 
Seat 2: Dragsta03 ($3.90 in chips) 
Seat 4: k1tt9nM1nd ($10.95 in chips) 
Seat 5: DSOR65 ($9.05 in chips) 
Seat 6: Hero ($6.45 in chips) 
Hero: posts small blind $0.05
Gles65: posts big blind $0.10
*** HOLE CARDS ***
Dealt to Hero [Kc 9c]
Dragsta03: folds 
k1tt9nM1nd: folds 
DSOR65: calls $0.10
Hero: raises $0.20 to $0.30
Pho3nix.two has returned
Gles65: folds 
DSOR65: calls $0.20
*** FLOP *** [Td 7c Jc]
Hero: bets $0.50
DSOR65: calls $0.50
*** TURN *** [Td 7c Jc] [9s]
Hero: checks 
DSOR65: bets $1
Hero: calls $1
*** RIVER *** [Td 7c Jc 9s] [Qs]
Hero: checks 
DSOR65: checks 
*** SHOW DOWN ***
Hero: shows [Kc 9c] (a straight, Nine to King)
DSOR65: mucks hand 
Hero collected $3.55 from pot
*** SUMMARY ***
Total pot $3.70 | Rake $0.15 
Board [Td 7c Jc 9s Qs]
Seat 1: Gles65 (big blind) folded before Flop
Seat 2: Dragsta03 folded before Flop (didn't bet)
Seat 4: k1tt9nM1nd folded before Flop (didn't bet)
Seat 5: DSOR65 (button) mucked [8h Jh]
Seat 6: Hero (small blind) showed [Kc 9c] and won ($3.55) with a straight, Nine to King



PokerStars Game #35824281084:  Hold'em No Limit ($0.05/$0.10 USD) - 2009/11/25 6:29:01 ET
Table 'May IV' 6-max Seat #6 is the button
Seat 1: Gles65 ($9.20 in chips) 
Seat 2: Dragsta03 ($3.90 in chips) 
Seat 3: Pho3nix.two ($8.90 in chips) 
Seat 4: k1tt9nM1nd ($10.95 in chips) 
Seat 5: DSOR65 ($7.25 in chips) 
Seat 6: Hero ($8.20 in chips) 
Gles65: posts small blind $0.05
Dragsta03: posts big blind $0.10
*** HOLE CARDS ***
Dealt to Hero [8s 9s]
Pho3nix.two: calls $0.10
k1tt9nM1nd: folds 
DSOR65: calls $0.10
Hero: raises $0.30 to $0.40
Gles65: calls $0.35
Dragsta03: folds 
Pho3nix.two: calls $0.30
DSOR65: calls $0.30
*** FLOP *** [Ah Tc 2d]
Gles65: checks 
Pho3nix.two: checks 
DSOR65: bets $0.40
Hero: folds 
Gles65: folds 
Pho3nix.two: calls $0.40
*** TURN *** [Ah Tc 2d] [Ks]
Pho3nix.two: checks 
DSOR65: bets $0.60
Pho3nix.two: folds 
Uncalled bet ($0.60) returned to DSOR65
DSOR65 collected $2.40 from pot
*** SUMMARY ***
Total pot $2.50 | Rake $0.10 
Board [Ah Tc 2d Ks]
Seat 1: Gles65 (small blind) folded on the Flop
Seat 2: Dragsta03 (big blind) folded before Flop
Seat 3: Pho3nix.two folded on the Turn
Seat 4: k1tt9nM1nd folded before Flop (didn't bet)
Seat 5: DSOR65 collected ($2.40)
Seat 6: Hero (button) folded on the Flop



PokerStars Game #35824302250:  Hold'em No Limit ($0.05/$0.10 USD) - 2009/11/25 6:30:03 ET
Table 'May IV' 6-max Seat #1 is the button
Seat 1: Gles65 ($10 in chips) 
Seat 2: Dragsta03 ($3.80 in chips) 
Seat 3: Pho3nix.two ($8.10 in chips) 
Seat 4: k1tt9nM1nd ($10.95 in chips) 
Seat 5: DSOR65 ($8.85 in chips) 
Seat 6: Hero ($7.80 in chips) 
Dragsta03: posts small blind $0.05
Pho3nix.two: posts big blind $0.10
*** HOLE CARDS ***
Dealt to Hero [7h Kh]
k1tt9nM1nd: folds 
DSOR65: calls $0.10
Hero: folds 
Gles65: folds 
Dragsta03: calls $0.05
Pho3nix.two: checks 
*** FLOP *** [9d Ts 4c]
Dragsta03: checks 
Pho3nix.two: checks 
DSOR65: checks 
*** TURN *** [9d Ts 4c] [Kd]
Dragsta03: checks 
Pho3nix.two: folds 
Pho3nix.two is sitting out
DSOR65: bets $0.10
Dragsta03: folds 
Uncalled bet ($0.10) returned to DSOR65
DSOR65 collected $0.30 from pot
*** SUMMARY ***
Total pot $0.30 | Rake $0 
Board [9d Ts 4c Kd]
Seat 1: Gles65 (button) folded before Flop (didn't bet)
Seat 2: Dragsta03 (small blind) folded on the Turn
Seat 3: Pho3nix.two (big blind) folded on the Turn
Seat 4: k1tt9nM1nd folded before Flop (didn't bet)
Seat 5: DSOR65 collected ($0.30)
Seat 6: Hero folded before Flop (didn't bet)



PokerStars Game #35824317532:  Hold'em No Limit ($0.05/$0.10 USD) - 2009/11/25 6:30:48 ET
Table 'May IV' 6-max Seat #2 is the button
Seat 1: Gles65 ($10 in chips) 
Seat 2: Dragsta03 ($3.70 in chips) 
Seat 4: k1tt9nM1nd ($10.95 in chips) 
Seat 5: DSOR65 ($9.05 in chips) 
Seat 6: Hero ($7.80 in chips) 
k1tt9nM1nd: posts small blind $0.05
DSOR65: posts big blind $0.10
*** HOLE CARDS ***
Dealt to Hero [5d 6h]
Hero: folds 
Gles65: folds 
Dragsta03: calls $0.10
k1tt9nM1nd: folds 
DSOR65: checks 
*** FLOP *** [6s 3c 3s]
DSOR65: checks 
Dragsta03: checks 
*** TURN *** [6s 3c 3s] [As]
DSOR65: bets $0.10
Dragsta03: folds 
Uncalled bet ($0.10) returned to DSOR65
DSOR65 collected $0.25 from pot
*** SUMMARY ***
Total pot $0.25 | Rake $0 
Board [6s 3c 3s As]
Seat 1: Gles65 folded before Flop (didn't bet)
Seat 2: Dragsta03 (button) folded on the Turn
Seat 4: k1tt9nM1nd (small blind) folded before Flop
Seat 5: DSOR65 (big blind) collected ($0.25)
Seat 6: Hero folded before Flop (didn't bet)



PokerStars Game #35824327130:  Hold'em No Limit ($0.05/$0.10 USD) - 2009/11/25 6:31:15 ET
Table 'May IV' 6-max Seat #4 is the button
Seat 1: Gles65 ($10 in chips) 
Seat 2: Dragsta03 ($3.60 in chips) 
Seat 4: k1tt9nM1nd ($10.90 in chips) 
Seat 5: DSOR65 ($9.20 in chips) 
Seat 6: Hero ($7.80 in chips) 
DSOR65: posts small blind $0.05
Hero: posts big blind $0.10
*** HOLE CARDS ***
Dealt to Hero [7d Qd]
Gles65: folds 
Dragsta03: folds 
k1tt9nM1nd: folds 
DSOR65: calls $0.05
Hero: checks 
*** FLOP *** [Jh 7s Qh]
DSOR65: checks 
Hero: bets $0.20
DSOR65: folds 
Uncalled bet ($0.20) returned to Hero
Hero collected $0.20 from pot
*** SUMMARY ***
Total pot $0.20 | Rake $0 
Board [Jh 7s Qh]
Seat 1: Gles65 folded before Flop (didn't bet)
Seat 2: Dragsta03 folded before Flop (didn't bet)
Seat 4: k1tt9nM1nd (button) folded before Flop (didn't bet)
Seat 5: DSOR65 (small blind) folded on the Flop
Seat 6: Hero (big blind) collected ($0.20)



PokerStars Game #35824337081:  Hold'em No Limit ($0.05/$0.10 USD) - 2009/11/25 6:31:44 ET
Table 'May IV' 6-max Seat #5 is the button
Seat 1: Gles65 ($10 in chips) 
Seat 2: Dragsta03 ($3.60 in chips) 
Seat 4: k1tt9nM1nd ($10.90 in chips) 
Seat 5: DSOR65 ($9.10 in chips) 
Seat 6: Hero ($7.90 in chips) 
Hero: posts small blind $0.05
Gles65: posts big blind $0.10
*** HOLE CARDS ***
Dealt to Hero [9h Ah]
Dragsta03: folds 
k1tt9nM1nd: folds 
DSOR65: calls $0.10
Hero: calls $0.05
Gles65: checks 
*** FLOP *** [6c 6h 2c]
Hero: checks 
Pho3nix.two has returned
Gles65: bets $0.30
DSOR65: folds 
Hero: folds 
Uncalled bet ($0.30) returned to Gles65
Gles65 collected $0.30 from pot
Gles65: doesn't show hand 
*** SUMMARY ***
Total pot $0.30 | Rake $0 
Board [6c 6h 2c]
Seat 1: Gles65 (big blind) collected ($0.30)
Seat 2: Dragsta03 folded before Flop (didn't bet)
Seat 4: k1tt9nM1nd folded before Flop (didn't bet)
Seat 5: DSOR65 (button) folded on the Flop
Seat 6: Hero (small blind) folded on the Flop



PokerStars Game #35824354870:  Hold'em No Limit ($0.05/$0.10 USD) - 2009/11/25 6:32:36 ET
Table 'May IV' 6-max Seat #6 is the button
Seat 1: Gles65 ($10.20 in chips) 
Seat 2: Dragsta03 ($3.60 in chips) 
Seat 4: k1tt9nM1nd ($10.90 in chips) 
Seat 5: DSOR65 ($9 in chips) 
Seat 6: Hero ($7.80 in chips) 
Gles65: posts small blind $0.05
Dragsta03: posts big blind $0.10
Pho3nix.two: sits out 
*** HOLE CARDS ***
Dealt to Hero [7h 7s]
k1tt9nM1nd: folds 
DSOR65: folds 
Hero: raises $0.20 to $0.30
Gles65: folds 
Dragsta03: calls $0.20
*** FLOP *** [8d 9h Jh]
Dragsta03: checks 
Hero: bets $0.50
Dragsta03: folds 
Uncalled bet ($0.50) returned to Hero
Hero collected $0.65 from pot
*** SUMMARY ***
Total pot $0.65 | Rake $0 
Board [8d 9h Jh]
Seat 1: Gles65 (small blind) folded before Flop
Seat 2: Dragsta03 (big blind) folded on the Flop
Seat 4: k1tt9nM1nd folded before Flop (didn't bet)
Seat 5: DSOR65 folded before Flop (didn't bet)
Seat 6: Hero (button) collected ($0.65)



PokerStars Game #35824372562:  Hold'em No Limit ($0.05/$0.10 USD) - 2009/11/25 6:33:29 ET
Table 'May IV' 6-max Seat #1 is the button
Seat 1: Gles65 ($10.15 in chips) 
Seat 4: k1tt9nM1nd ($10.90 in chips) 
Seat 5: DSOR65 ($9 in chips) 
Seat 6: Hero ($8.15 in chips) 
Dragsta03: is sitting out 
Pho3nix.two will be allowed to play after the button
Dragsta03 leaves the table
k1tt9nM1nd: posts small blind $0.05
DSOR65: posts big blind $0.10
*** HOLE CARDS ***
Dealt to Hero [Tc 2c]
Hero: folds 
Gles65: folds 
Swiss777 joins the table at seat #2 
k1tt9nM1nd: folds 
Uncalled bet ($0.05) returned to DSOR65
DSOR65 collected $0.10 from pot
*** SUMMARY ***
Total pot $0.10 | Rake $0 
Seat 1: Gles65 (button) folded before Flop (didn't bet)
Seat 4: k1tt9nM1nd (small blind) folded before Flop
Seat 5: DSOR65 (big blind) collected ($0.10)
Seat 6: Hero folded before Flop (didn't bet)



PokerStars Game #35824379534:  Hold'em No Limit ($0.05/$0.10 USD) - 2009/11/25 6:33:49 ET
Table 'May IV' 6-max Seat #4 is the button
Seat 1: Gles65 ($10.15 in chips) 
Seat 4: k1tt9nM1nd ($10.85 in chips) 
Seat 5: DSOR65 ($9.05 in chips) 
Seat 6: Hero ($8.15 in chips) 
DSOR65: posts small blind $0.05
Hero: posts big blind $0.10
Swiss777: sits out 
Pho3nix.two: sits out 
*** HOLE CARDS ***
Dealt to Hero [4d Js]
Gles65: folds 
k1tt9nM1nd: folds 
DSOR65: calls $0.05
Hero: checks 
*** FLOP *** [Qd 2c 5d]
DSOR65: checks 
Hero: checks 
*** TURN *** [Qd 2c 5d] [6s]
DSOR65: checks 
Hero: checks 
*** RIVER *** [Qd 2c 5d 6s] [3s]
DSOR65: checks 
Hero: bets $0.30
DSOR65: folds 
Uncalled bet ($0.30) returned to Hero
Hero collected $0.20 from pot
*** SUMMARY ***
Total pot $0.20 | Rake $0 
Board [Qd 2c 5d 6s 3s]
Seat 1: Gles65 folded before Flop (didn't bet)
Seat 4: k1tt9nM1nd (button) folded before Flop (didn't bet)
Seat 5: DSOR65 (small blind) folded on the River
Seat 6: Hero (big blind) collected ($0.20)



PokerStars Game #35824392581:  Hold'em No Limit ($0.05/$0.10 USD) - 2009/11/25 6:34:27 ET
Table 'May IV' 6-max Seat #5 is the button
Seat 1: Gles65 ($10.15 in chips) 
Seat 4: k1tt9nM1nd ($10.85 in chips) 
Seat 5: DSOR65 ($8.95 in chips) 
Seat 6: Hero ($8.25 in chips) 
Hero: posts small blind $0.05
Gles65: posts big blind $0.10
Swiss777: sits out 
Pho3nix.two: sits out 
*** HOLE CARDS ***
Dealt to Hero [7h 2h]
k1tt9nM1nd: folds 
DSOR65: folds 
Hero: folds 
Uncalled bet ($0.05) returned to Gles65
Gles65 collected $0.10 from pot
Gles65: doesn't show hand 
*** SUMMARY ***
Total pot $0.10 | Rake $0 
Seat 1: Gles65 (big blind) collected ($0.10)
Seat 4: k1tt9nM1nd folded before Flop (didn't bet)
Seat 5: DSOR65 (button) folded before Flop (didn't bet)
Seat 6: Hero (small blind) folded before Flop



PokerStars Game #35824396158:  Hold'em No Limit ($0.05/$0.10 USD) - 2009/11/25 6:34:37 ET
Table 'May IV' 6-max Seat #6 is the button
Seat 1: Gles65 ($10.20 in chips) 
Seat 2: Swiss777 ($10 in chips) 
Seat 4: k1tt9nM1nd ($10.85 in chips) 
Seat 5: DSOR65 ($8.95 in chips) 
Seat 6: Hero ($8.20 in chips) 
Gles65: posts small blind $0.05
Swiss777: posts big blind $0.10
Pho3nix.two: sits out 
*** HOLE CARDS ***
Dealt to Hero [Qd Qs]
k1tt9nM1nd: folds 
DSOR65: folds 
Hero: raises $0.20 to $0.30
Gles65: raises $0.60 to $0.90
Swiss777: folds 
Hero: calls $0.60
*** FLOP *** [8d Ks 3s]
Gles65: bets $1.30
Hero: calls $1.30
*** TURN *** [8d Ks 3s] [4s]
Gles65: checks 
Hero: bets $6 and is all-in
Gles65: folds 
Uncalled bet ($6) returned to Hero
Hero collected $4.30 from pot
*** SUMMARY ***
Total pot $4.50 | Rake $0.20 
Board [8d Ks 3s 4s]
Seat 1: Gles65 (small blind) folded on the Turn
Seat 2: Swiss777 (big blind) folded before Flop
Seat 4: k1tt9nM1nd folded before Flop (didn't bet)
Seat 5: DSOR65 folded before Flop (didn't bet)
Seat 6: Hero (button) collected ($4.30)



PokerStars Game #35824426363:  Hold'em No Limit ($0.05/$0.10 USD) - 2009/11/25 6:36:06 ET
Table 'May IV' 6-max Seat #1 is the button
Seat 1: Gles65 ($10 in chips) 
Seat 2: Swiss777 ($10 in chips) 
Seat 3: Pho3nix.two ($8 in chips) 
Seat 4: k1tt9nM1nd ($10.85 in chips) 
Seat 5: DSOR65 ($8.95 in chips) 
Seat 6: Hero ($10.30 in chips) 
Swiss777: posts small blind $0.05
Pho3nix.two: posts big blind $0.10
*** HOLE CARDS ***
Dealt to Hero [Qc Ad]
k1tt9nM1nd: raises $0.30 to $0.40
DSOR65: calls $0.40
Hero: calls $0.40
Gles65 has timed out
Gles65: folds 
Gles65 is sitting out
Gles65 has returned
Swiss777: folds 
Pho3nix.two: folds 
*** FLOP *** [Td 8c Ac]
k1tt9nM1nd: bets $1
DSOR65: calls $1
Hero: calls $1
*** TURN *** [Td 8c Ac] [6h]
k1tt9nM1nd: checks 
DSOR65: checks 
Hero: checks 
*** RIVER *** [Td 8c Ac 6h] [Tc]
k1tt9nM1nd: checks 
DSOR65: checks 
Hero: checks 
*** SHOW DOWN ***
k1tt9nM1nd: shows [Jh As] (two pair, Aces and Tens)
DSOR65: mucks hand 
Hero: shows [Qc Ad] (two pair, Aces and Tens - Queen kicker)
Hero collected $4.15 from pot
*** SUMMARY ***
Total pot $4.35 | Rake $0.20 
Board [Td 8c Ac 6h Tc]
Seat 1: Gles65 (button) folded before Flop (didn't bet)
Seat 2: Swiss777 (small blind) folded before Flop
Seat 3: Pho3nix.two (big blind) folded before Flop
Seat 4: k1tt9nM1nd showed [Jh As] and lost with two pair, Aces and Tens
Seat 5: DSOR65 mucked [Ks Js]
Seat 6: Hero showed [Qc Ad] and won ($4.15) with two pair, Aces and Tens



PokerStars Game #35824453955:  Hold'em No Limit ($0.05/$0.10 USD) - 2009/11/25 6:37:27 ET
Table 'May IV' 6-max Seat #2 is the button
Seat 1: Gles65 ($10 in chips) 
Seat 2: Swiss777 ($10 in chips) 
Seat 3: Pho3nix.two ($7.90 in chips) 
Seat 4: k1tt9nM1nd ($10 in chips) 
Seat 5: DSOR65 ($7.55 in chips) 
Seat 6: Hero ($13.05 in chips) 
Pho3nix.two: posts small blind $0.05
k1tt9nM1nd: posts big blind $0.10
*** HOLE CARDS ***
Dealt to Hero [Qh 9h]
DSOR65: calls $0.10
Hero: calls $0.10
Gles65 has timed out
Gles65: folds 
Gles65 is sitting out
Gles65 has returned
Swiss777: folds 
Pho3nix.two: calls $0.05
k1tt9nM1nd: checks 
*** FLOP *** [3c 4s 7h]
Pho3nix.two: checks 
k1tt9nM1nd: checks 
DSOR65: checks 
Hero: checks 
*** TURN *** [3c 4s 7h] [Kc]
Pho3nix.two: checks 
k1tt9nM1nd: bets $0.40
DSOR65: folds 
Hero: folds 
Pho3nix.two: folds 
Uncalled bet ($0.40) returned to k1tt9nM1nd
k1tt9nM1nd collected $0.40 from pot
*** SUMMARY ***
Total pot $0.40 | Rake $0 
Board [3c 4s 7h Kc]
Seat 1: Gles65 folded before Flop (didn't bet)
Seat 2: Swiss777 (button) folded before Flop (didn't bet)
Seat 3: Pho3nix.two (small blind) folded on the Turn
Seat 4: k1tt9nM1nd (big blind) collected ($0.40)
Seat 5: DSOR65 folded on the Turn
Seat 6: Hero folded on the Turn



PokerStars Game #35824474603:  Hold'em No Limit ($0.05/$0.10 USD) - 2009/11/25 6:38:28 ET
Table 'May IV' 6-max Seat #3 is the button
Seat 1: Gles65 ($10 in chips) 
Seat 2: Swiss777 ($10 in chips) 
Seat 3: Pho3nix.two ($7.80 in chips) 
Seat 4: k1tt9nM1nd ($10.30 in chips) 
Seat 5: DSOR65 ($7.45 in chips) 
Seat 6: Hero ($12.95 in chips) 
k1tt9nM1nd: posts small blind $0.05
DSOR65: posts big blind $0.10
*** HOLE CARDS ***
Dealt to Hero [7d Ac]
Hero: folds 
Gles65: folds 
Swiss777: folds 
Pho3nix.two: raises $0.20 to $0.30
k1tt9nM1nd: folds 
DSOR65: calls $0.20
*** FLOP *** [7c 4s 3h]
DSOR65: bets $0.40
Pho3nix.two: raises $0.80 to $1.20
DSOR65: calls $0.80
*** TURN *** [7c 4s 3h] [2c]
DSOR65: checks 
Pho3nix.two: bets $1.90
DSOR65: calls $1.90
*** RIVER *** [7c 4s 3h 2c] [Tc]
DSOR65: checks 
Pho3nix.two: checks 
*** SHOW DOWN ***
DSOR65: shows [5h 5d] (a pair of Fives)
Pho3nix.two: mucks hand 
DSOR65 collected $6.55 from pot
*** SUMMARY ***
Total pot $6.85 | Rake $0.30 
Board [7c 4s 3h 2c Tc]
Seat 1: Gles65 folded before Flop (didn't bet)
Seat 2: Swiss777 folded before Flop (didn't bet)
Seat 3: Pho3nix.two (button) mucked [Js 8c]
Seat 4: k1tt9nM1nd (small blind) folded before Flop
Seat 5: DSOR65 (big blind) showed [5h 5d] and won ($6.55) with a pair of Fives
Seat 6: Hero folded before Flop (didn't bet)



PokerStars Game #35824510640:  Hold'em No Limit ($0.05/$0.10 USD) - 2009/11/25 6:40:13 ET
Table 'May IV' 6-max Seat #4 is the button
Seat 1: Gles65 ($10 in chips) 
Seat 2: Swiss777 ($10 in chips) 
Seat 3: Pho3nix.two ($4.40 in chips) 
Seat 4: k1tt9nM1nd ($10.25 in chips) 
Seat 5: DSOR65 ($10.60 in chips) 
Seat 6: Hero ($12.95 in chips) 
DSOR65: posts small blind $0.05
Hero: posts big blind $0.10
*** HOLE CARDS ***
Dealt to Hero [4c 5c]
Gles65: folds 
Swiss777: folds 
Pho3nix.two: folds 
k1tt9nM1nd: folds 
DSOR65: calls $0.05
Hero: checks 
*** FLOP *** [5s 5d 5h]
DSOR65: checks 
Hero: checks 
*** TURN *** [5s 5d 5h] [6c]
DSOR65: bets $0.10
Hero: calls $0.10
*** RIVER *** [5s 5d 5h 6c] [2h]
DSOR65: bets $0.10
Hero: raises $0.30 to $0.40
DSOR65: folds 
Uncalled bet ($0.30) returned to Hero
Hero collected $0.60 from pot
*** SUMMARY ***
Total pot $0.60 | Rake $0 
Board [5s 5d 5h 6c 2h]
Seat 1: Gles65 folded before Flop (didn't bet)
Seat 2: Swiss777 folded before Flop (didn't bet)
Seat 3: Pho3nix.two folded before Flop (didn't bet)
Seat 4: k1tt9nM1nd (button) folded before Flop (didn't bet)
Seat 5: DSOR65 (small blind) folded on the River
Seat 6: Hero (big blind) collected ($0.60)



PokerStars Game #35824527128:  Hold'em No Limit ($0.05/$0.10 USD) - 2009/11/25 6:41:01 ET
Table 'May IV' 6-max Seat #5 is the button
Seat 1: Gles65 ($10 in chips) 
Seat 2: Swiss777 ($10 in chips) 
Seat 3: Pho3nix.two ($4.40 in chips) 
Seat 4: k1tt9nM1nd ($10.25 in chips) 
Seat 5: DSOR65 ($10.30 in chips) 
Seat 6: Hero ($13.25 in chips) 
Hero: posts small blind $0.05
Gles65: posts big blind $0.10
*** HOLE CARDS ***
Dealt to Hero [4h Qh]
Swiss777: folds 
Pho3nix.two: calls $0.10
k1tt9nM1nd: raises $0.40 to $0.50
DSOR65: folds 
Hero: folds 
Gles65: folds 
Pho3nix.two: calls $0.40
*** FLOP *** [9h 8s 3c]
Pho3nix.two: checks 
k1tt9nM1nd: bets $0.70
Pho3nix.two: raises $1.10 to $1.80
k1tt9nM1nd: raises $7.50 to $9.30
Pho3nix.two: calls $2.10 and is all-in
Uncalled bet ($5.40) returned to k1tt9nM1nd
*** TURN *** [9h 8s 3c] [8d]
*** RIVER *** [9h 8s 3c 8d] [4c]
*** SHOW DOWN ***
Pho3nix.two: shows [Jd 9s] (two pair, Nines and Eights)
k1tt9nM1nd: shows [Ac 9d] (two pair, Nines and Eights - Ace kicker)
k1tt9nM1nd collected $8.55 from pot
*** SUMMARY ***
Total pot $8.95 | Rake $0.40 
Board [9h 8s 3c 8d 4c]
Seat 1: Gles65 (big blind) folded before Flop
Seat 2: Swiss777 folded before Flop (didn't bet)
Seat 3: Pho3nix.two showed [Jd 9s] and lost with two pair, Nines and Eights
Seat 4: k1tt9nM1nd showed [Ac 9d] and won ($8.55) with two pair, Nines and Eights
Seat 5: DSOR65 (button) folded before Flop (didn't bet)
Seat 6: Hero (small blind) folded before Flop



PokerStars Game #35824546507:  Hold'em No Limit ($0.05/$0.10 USD) - 2009/11/25 6:41:58 ET
Table 'May IV' 6-max Seat #6 is the button
Seat 1: Gles65 ($9.90 in chips) 
Seat 2: Swiss777 ($10 in chips) 
Seat 4: k1tt9nM1nd ($14.40 in chips) 
Seat 5: DSOR65 ($10.30 in chips) 
Seat 6: Hero ($13.20 in chips) 
Gles65: posts small blind $0.05
Swiss777: posts big blind $0.10
*** HOLE CARDS ***
Dealt to Hero [3c Qc]
k1tt9nM1nd: folds 
Pho3nix.two leaves the table
DSOR65: calls $0.10
Hero: folds 
Gles65: calls $0.05
Dashornman joins the table at seat #3 
Swiss777: checks 
*** FLOP *** [Td Jc 5c]
Gles65: bets $0.20
Swiss777: folds 
DSOR65: calls $0.20
*** TURN *** [Td Jc 5c] [6c]
Gles65: checks 
DSOR65: bets $0.60
Gles65: calls $0.60
*** RIVER *** [Td Jc 5c 6c] [8d]
Gles65: checks 
DSOR65: bets $1.30
Gles65: calls $1.30
*** SHOW DOWN ***
DSOR65: shows [Kc Kh] (a pair of Kings)
Gles65: shows [9d Qh] (a straight, Eight to Queen)
Gles65 collected $4.30 from pot
*** SUMMARY ***
Total pot $4.50 | Rake $0.20 
Board [Td Jc 5c 6c 8d]
Seat 1: Gles65 (small blind) showed [9d Qh] and won ($4.30) with a straight, Eight to Queen
Seat 2: Swiss777 (big blind) folded on the Flop
Seat 4: k1tt9nM1nd folded before Flop (didn't bet)
Seat 5: DSOR65 showed [Kc Kh] and lost with a pair of Kings
Seat 6: Hero (button) folded before Flop (didn't bet)



PokerStars Game #35824571658:  Hold'em No Limit ($0.05/$0.10 USD) - 2009/11/25 6:43:09 ET
Table 'May IV' 6-max Seat #1 is the button
Seat 1: Gles65 ($12 in chips) 
Seat 2: Swiss777 ($10 in chips) 
Seat 3: Dashornman ($10 in chips) 
Seat 4: k1tt9nM1nd ($14.40 in chips) 
Seat 5: DSOR65 ($8.10 in chips) 
Seat 6: Hero ($13.20 in chips) 
Swiss777: posts small blind $0.05
Dashornman: posts big blind $0.10
*** HOLE CARDS ***
Dealt to Hero [4c Qh]
k1tt9nM1nd: folds 
DSOR65: folds 
Hero: folds 
Gles65: folds 
Swiss777: folds 
Uncalled bet ($0.05) returned to Dashornman
Dashornman collected $0.10 from pot
Dashornman: doesn't show hand 
*** SUMMARY ***
Total pot $0.10 | Rake $0 
Seat 1: Gles65 (button) folded before Flop (didn't bet)
Seat 2: Swiss777 (small blind) folded before Flop
Seat 3: Dashornman (big blind) collected ($0.10)
Seat 4: k1tt9nM1nd folded before Flop (didn't bet)
Seat 5: DSOR65 folded before Flop (didn't bet)
Seat 6: Hero folded before Flop (didn't bet)



PokerStars Game #35824579763:  Hold'em No Limit ($0.05/$0.10 USD) - 2009/11/25 6:43:33 ET
Table 'May IV' 6-max Seat #2 is the button
Seat 1: Gles65 ($12 in chips) 
Seat 2: Swiss777 ($10 in chips) 
Seat 3: Dashornman ($10.05 in chips) 
Seat 4: k1tt9nM1nd ($14.40 in chips) 
Seat 5: DSOR65 ($8.10 in chips) 
Seat 6: Hero ($13.20 in chips) 
Dashornman: posts small blind $0.05
k1tt9nM1nd: posts big blind $0.10
*** HOLE CARDS ***
Dealt to Hero [Qd Qh]
DSOR65: folds 
Hero: raises $0.20 to $0.30
Gles65: calls $0.30
Swiss777: calls $0.30
Dashornman: folds 
k1tt9nM1nd: folds 
*** FLOP *** [4h Td Qs]
Hero: checks 
Gles65: bets $1
Swiss777: folds 
Hero: calls $1
*** TURN *** [4h Td Qs] [7h]
Hero: checks 
Gles65: bets $3
Hero: calls $3
*** RIVER *** [4h Td Qs 7h] [6c]
Hero: bets $8.90 and is all-in
Gles65: calls $7.70 and is all-in
Uncalled bet ($1.20) returned to Hero
*** SHOW DOWN ***
Hero: shows [Qd Qh] (three of a kind, Queens)
Gles65: shows [Ad Ac] (a pair of Aces)
Hero collected $23.25 from pot
*** SUMMARY ***
Total pot $24.45 | Rake $1.20 
Board [4h Td Qs 7h 6c]
Seat 1: Gles65 showed [Ad Ac] and lost with a pair of Aces
Seat 2: Swiss777 (button) folded on the Flop
Seat 3: Dashornman (small blind) folded before Flop
Seat 4: k1tt9nM1nd (big blind) folded before Flop
Seat 5: DSOR65 folded before Flop (didn't bet)
Seat 6: Hero showed [Qd Qh] and won ($23.25) with three of a kind, Queens



PokerStars Game #35824607306:  Hold'em No Limit ($0.05/$0.10 USD) - 2009/11/25 6:44:52 ET
Table 'May IV' 6-max Seat #3 is the button
Seat 1: Gles65 ($10 in chips) 
Seat 2: Swiss777 ($10 in chips) 
Seat 3: Dashornman ($10 in chips) 
Seat 4: k1tt9nM1nd ($14.30 in chips) 
Seat 5: DSOR65 ($8.10 in chips) 
Seat 6: Hero ($24.45 in chips) 
k1tt9nM1nd: posts small blind $0.05
DSOR65: posts big blind $0.10
*** HOLE CARDS ***
Dealt to Hero [4s 9c]
Hero: folds 
Gles65: folds 
Swiss777: folds 
Dashornman: folds 
Dashornman is sitting out
k1tt9nM1nd: folds 
Uncalled bet ($0.05) returned to DSOR65
DSOR65 collected $0.10 from pot
*** SUMMARY ***
Total pot $0.10 | Rake $0 
Seat 1: Gles65 folded before Flop (didn't bet)
Seat 2: Swiss777 folded before Flop (didn't bet)
Seat 3: Dashornman (button) folded before Flop (didn't bet)
Seat 4: k1tt9nM1nd (small blind) folded before Flop
Seat 5: DSOR65 (big blind) collected ($0.10)
Seat 6: Hero folded before Flop (didn't bet)



PokerStars Game #35824615928:  Hold'em No Limit ($0.05/$0.10 USD) - 2009/11/25 6:45:15 ET
Table 'May IV' 6-max Seat #4 is the button
Seat 1: Gles65 ($10 in chips) 
Seat 2: Swiss777 ($10 in chips) 
Seat 4: k1tt9nM1nd ($14.25 in chips) 
Seat 5: DSOR65 ($8.15 in chips) 
Seat 6: Hero ($24.45 in chips) 
DSOR65: posts small blind $0.05
Hero: posts big blind $0.10
*** HOLE CARDS ***
Dealt to Hero [6d 5h]
Gles65: calls $0.10
Swiss777: folds 
k1tt9nM1nd: raises $0.40 to $0.50
DSOR65: calls $0.45
Hero: folds 
Gles65: calls $0.40
*** FLOP *** [3s 6h 8s]
DSOR65: checks 
Gles65: checks 
k1tt9nM1nd: bets $1.20
DSOR65: folds 
Gles65: folds 
Uncalled bet ($1.20) returned to k1tt9nM1nd
k1tt9nM1nd collected $1.55 from pot
*** SUMMARY ***
Total pot $1.60 | Rake $0.05 
Board [3s 6h 8s]
Seat 1: Gles65 folded on the Flop
Seat 2: Swiss777 folded before Flop (didn't bet)
Seat 4: k1tt9nM1nd (button) collected ($1.55)
Seat 5: DSOR65 (small blind) folded on the Flop
Seat 6: Hero (big blind) folded before Flop



PokerStars Game #35824637340:  Hold'em No Limit ($0.05/$0.10 USD) - 2009/11/25 6:46:15 ET
Table 'May IV' 6-max Seat #5 is the button
Seat 1: Gles65 ($9.50 in chips) 
Seat 2: Swiss777 ($10 in chips) 
Seat 4: k1tt9nM1nd ($15.30 in chips) 
Seat 5: DSOR65 ($7.65 in chips) 
Seat 6: Hero ($24.35 in chips) 
Hero: posts small blind $0.05
Gles65: posts big blind $0.10
*** HOLE CARDS ***
Dealt to Hero [Td 5h]
Swiss777: folds 
k1tt9nM1nd: folds 
DSOR65: folds 
Hero: folds 
Uncalled bet ($0.05) returned to Gles65
Gles65 collected $0.10 from pot
Gles65: doesn't show hand 
*** SUMMARY ***
Total pot $0.10 | Rake $0 
Seat 1: Gles65 (big blind) collected ($0.10)
Seat 2: Swiss777 folded before Flop (didn't bet)
Seat 4: k1tt9nM1nd folded before Flop (didn't bet)
Seat 5: DSOR65 (button) folded before Flop (didn't bet)
Seat 6: Hero (small blind) folded before Flop



PokerStars Game #35824641385:  Hold'em No Limit ($0.05/$0.10 USD) - 2009/11/25 6:46:26 ET
Table 'May IV' 6-max Seat #6 is the button
Seat 1: Gles65 ($9.55 in chips) 
Seat 2: Swiss777 ($10 in chips) 
Seat 4: k1tt9nM1nd ($15.30 in chips) 
Seat 5: DSOR65 ($7.65 in chips) 
Seat 6: Hero ($24.30 in chips) 
Gles65: posts small blind $0.05
Swiss777: posts big blind $0.10
*** HOLE CARDS ***
Dealt to Hero [Jh 5s]
k1tt9nM1nd: folds 
DSOR65 has timed out
DSOR65: folds 
DSOR65 is sitting out
Hero: folds 
Gles65: folds 
Uncalled bet ($0.05) returned to Swiss777
Swiss777 collected $0.10 from pot
Swiss777: doesn't show hand 
*** SUMMARY ***
Total pot $0.10 | Rake $0 
Seat 1: Gles65 (small blind) folded before Flop
Seat 2: Swiss777 (big blind) collected ($0.10)
Seat 4: k1tt9nM1nd folded before Flop (didn't bet)
Seat 5: DSOR65 folded before Flop (didn't bet)
Seat 6: Hero (button) folded before Flop (didn't bet)



PokerStars Game #35824651611:  Hold'em No Limit ($0.05/$0.10 USD) - 2009/11/25 6:46:54 ET
Table 'May IV' 6-max Seat #1 is the button
Seat 1: Gles65 ($9.50 in chips) 
Seat 2: Swiss777 ($10.05 in chips) 
Seat 4: k1tt9nM1nd ($15.30 in chips) 
Seat 6: Hero ($24.30 in chips) 
Swiss777: posts small blind $0.05
k1tt9nM1nd: posts big blind $0.10
*** HOLE CARDS ***
Dealt to Hero [Kd 8s]
Hero: folds 
DSOR65 has returned
Gles65: folds 
Swiss777: folds 
Uncalled bet ($0.05) returned to k1tt9nM1nd
k1tt9nM1nd collected $0.10 from pot
*** SUMMARY ***
Total pot $0.10 | Rake $0 
Seat 1: Gles65 (button) folded before Flop (didn't bet)
Seat 2: Swiss777 (small blind) folded before Flop
Seat 4: k1tt9nM1nd (big blind) collected ($0.10)
Seat 6: Hero folded before Flop (didn't bet)



PokerStars Game #35824656751:  Hold'em No Limit ($0.05/$0.10 USD) - 2009/11/25 6:47:08 ET
Table 'May IV' 6-max Seat #2 is the button
Seat 1: Gles65 ($9.50 in chips) 
Seat 2: Swiss777 ($10 in chips) 
Seat 4: k1tt9nM1nd ($15.35 in chips) 
Seat 5: DSOR65 ($7.65 in chips) 
Seat 6: Hero ($24.30 in chips) 
k1tt9nM1nd: posts small blind $0.05
DSOR65: posts big blind $0.10
*** HOLE CARDS ***
Dealt to Hero [6d Qc]
Hero: folds 
Gles65: folds 
Swiss777: raises $0.30 to $0.40
k1tt9nM1nd: folds 
DSOR65: calls $0.30
*** FLOP *** [4h 4c 8s]
DSOR65: checks 
Swiss777: bets $0.70
DSOR65: calls $0.70
*** TURN *** [4h 4c 8s] [Ts]
Dashornman leaves the table
DSOR65: checks 
Swiss777: checks 
*** RIVER *** [4h 4c 8s Ts] [3s]
StifflerPL joins the table at seat #3 
DSOR65: bets $1.30
Swiss777: calls $1.30
*** SHOW DOWN ***
DSOR65: shows [8d Jc] (two pair, Eights and Fours)
Swiss777: shows [9d 9s] (two pair, Nines and Fours)
Swiss777 collected $4.65 from pot
*** SUMMARY ***
Total pot $4.85 | Rake $0.20 
Board [4h 4c 8s Ts 3s]
Seat 1: Gles65 folded before Flop (didn't bet)
Seat 2: Swiss777 (button) showed [9d 9s] and won ($4.65) with two pair, Nines and Fours
Seat 4: k1tt9nM1nd (small blind) folded before Flop
Seat 5: DSOR65 (big blind) showed [8d Jc] and lost with two pair, Eights and Fours
Seat 6: Hero folded before Flop (didn't bet)



PokerStars Game #35824669713:  Hold'em No Limit ($0.05/$0.10 USD) - 2009/11/25 6:47:44 ET
Table 'May IV' 6-max Seat #4 is the button
Seat 1: Gles65 ($9.50 in chips) 
Seat 2: Swiss777 ($12.25 in chips) 
Seat 4: k1tt9nM1nd ($15.30 in chips) 
Seat 5: DSOR65 ($5.25 in chips) 
Seat 6: Hero ($24.30 in chips) 
DSOR65: posts small blind $0.05
Hero: posts big blind $0.10
StifflerPL: sits out 
*** HOLE CARDS ***
Dealt to Hero [Js 9c]
Gles65 has timed out
Gles65: folds 
Gles65 is sitting out
Gles65 has returned
Swiss777: folds 
k1tt9nM1nd: raises $0.20 to $0.30
DSOR65: calls $0.25
Hero: folds 
*** FLOP *** [4s Jc 4c]
DSOR65: checks 
k1tt9nM1nd: checks 
*** TURN *** [4s Jc 4c] [8s]
DSOR65: bets $0.50
k1tt9nM1nd: folds 
Uncalled bet ($0.50) returned to DSOR65
DSOR65 collected $0.70 from pot
*** SUMMARY ***
Total pot $0.70 | Rake $0 
Board [4s Jc 4c 8s]
Seat 1: Gles65 folded before Flop (didn't bet)
Seat 2: Swiss777 folded before Flop (didn't bet)
Seat 4: k1tt9nM1nd (button) folded on the Turn
Seat 5: DSOR65 (small blind) collected ($0.70)
Seat 6: Hero (big blind) folded before Flop



PokerStars Game #35824693077:  Hold'em No Limit ($0.05/$0.10 USD) - 2009/11/25 6:48:48 ET
Table 'May IV' 6-max Seat #5 is the button
Seat 1: Gles65 ($9.50 in chips) 
Seat 2: Swiss777 ($12.25 in chips) 
Seat 3: StifflerPL ($10 in chips) 
Seat 4: k1tt9nM1nd ($15 in chips) 
Seat 5: DSOR65 ($5.65 in chips) 
Seat 6: Hero ($24.20 in chips) 
Hero: posts small blind $0.05
Gles65: posts big blind $0.10
StifflerPL: posts big blind $0.10
*** HOLE CARDS ***
Dealt to Hero [Ah 7d]
Swiss777: folds 
StifflerPL: checks 
k1tt9nM1nd: folds 
DSOR65: folds 
Hero: calls $0.05
Gles65: checks 
*** FLOP *** [5d Td Ac]
Hero: checks 
Gles65: checks 
StifflerPL: checks 
*** TURN *** [5d Td Ac] [4s]
Hero: bets $0.20
Gles65: folds 
StifflerPL: folds 
Uncalled bet ($0.20) returned to Hero
Hero collected $0.30 from pot
*** SUMMARY ***
Total pot $0.30 | Rake $0 
Board [5d Td Ac 4s]
Seat 1: Gles65 (big blind) folded on the Turn
Seat 2: Swiss777 folded before Flop (didn't bet)
Seat 3: StifflerPL folded on the Turn
Seat 4: k1tt9nM1nd folded before Flop (didn't bet)
Seat 5: DSOR65 (button) folded before Flop (didn't bet)
Seat 6: Hero (small blind) collected ($0.30)



PokerStars Game #35824715133:  Hold'em No Limit ($0.05/$0.10 USD) - 2009/11/25 6:49:49 ET
Table 'May IV' 6-max Seat #6 is the button
Seat 1: Gles65 ($9.40 in chips) 
Seat 2: Swiss777 ($12.25 in chips) 
Seat 3: StifflerPL ($9.90 in chips) 
Seat 4: k1tt9nM1nd ($15 in chips) 
Seat 5: DSOR65 ($5.65 in chips) 
Seat 6: Hero ($24.40 in chips) 
Gles65: posts small blind $0.05
Swiss777: posts big blind $0.10
*** HOLE CARDS ***
Dealt to Hero [9s 7s]
StifflerPL: folds 
k1tt9nM1nd: folds 
DSOR65: calls $0.10
Hero: raises $0.20 to $0.30
Gles65: calls $0.25
Swiss777: folds 
DSOR65: calls $0.20
*** FLOP *** [3c Qc Js]
Gles65: checks 
DSOR65: checks 
Hero: bets $0.60
Gles65: calls $0.60
DSOR65: folds 
*** TURN *** [3c Qc Js] [Kd]
Gles65: checks 
Hero: bets $1.50
Gles65: calls $1.50
*** RIVER *** [3c Qc Js Kd] [3s]
Gles65: bets $7 and is all-in
Hero: folds 
Uncalled bet ($7) returned to Gles65
Gles65 collected $4.95 from pot
Gles65: doesn't show hand 
*** SUMMARY ***
Total pot $5.20 | Rake $0.25 
Board [3c Qc Js Kd 3s]
Seat 1: Gles65 (small blind) collected ($4.95)
Seat 2: Swiss777 (big blind) folded before Flop
Seat 3: StifflerPL folded before Flop (didn't bet)
Seat 4: k1tt9nM1nd folded before Flop (didn't bet)
Seat 5: DSOR65 folded on the Flop
Seat 6: Hero (button) folded on the River



PokerStars Game #35824742563:  Hold'em No Limit ($0.05/$0.10 USD) - 2009/11/25 6:51:06 ET
Table 'May IV' 6-max Seat #1 is the button
Seat 1: Gles65 ($11.95 in chips) 
Seat 2: Swiss777 ($12.15 in chips) 
Seat 3: StifflerPL ($9.90 in chips) 
Seat 4: k1tt9nM1nd ($15 in chips) 
Seat 5: DSOR65 ($5.35 in chips) 
Seat 6: Hero ($22 in chips) 
Swiss777: posts small blind $0.05
StifflerPL: posts big blind $0.10
*** HOLE CARDS ***
Dealt to Hero [Qh 4h]
k1tt9nM1nd: folds 
DSOR65: calls $0.10
Hero: folds 
Gles65: folds 
Swiss777: folds 
StifflerPL: checks 
*** FLOP *** [3d 5d 3s]
StifflerPL: checks 
DSOR65: checks 
*** TURN *** [3d 5d 3s] [5c]
StifflerPL: bets $0.20
DSOR65: calls $0.20
*** RIVER *** [3d 5d 3s 5c] [Ac]
StifflerPL: bets $0.70
DSOR65: folds 
Uncalled bet ($0.70) returned to StifflerPL
StifflerPL collected $0.65 from pot
StifflerPL: doesn't show hand 
*** SUMMARY ***
Total pot $0.65 | Rake $0 
Board [3d 5d 3s 5c Ac]
Seat 1: Gles65 (button) folded before Flop (didn't bet)
Seat 2: Swiss777 (small blind) folded before Flop
Seat 3: StifflerPL (big blind) collected ($0.65)
Seat 4: k1tt9nM1nd folded before Flop (didn't bet)
Seat 5: DSOR65 folded on the River
Seat 6: Hero folded before Flop (didn't bet)



PokerStars Game #35824756274:  Hold'em No Limit ($0.05/$0.10 USD) - 2009/11/25 6:51:44 ET
Table 'May IV' 6-max Seat #2 is the button
Seat 1: Gles65 ($11.95 in chips) 
Seat 2: Swiss777 ($12.10 in chips) 
Seat 3: StifflerPL ($10.25 in chips) 
Seat 4: k1tt9nM1nd ($15 in chips) 
Seat 5: DSOR65 ($5.05 in chips) 
Seat 6: Hero ($22 in chips) 
StifflerPL: posts small blind $0.05
k1tt9nM1nd: posts big blind $0.10
*** HOLE CARDS ***
Dealt to Hero [Qh 5d]
DSOR65: calls $0.10
Hero: folds 
Gles65: folds 
Swiss777: raises $0.40 to $0.50
StifflerPL: folds 
k1tt9nM1nd: folds 
DSOR65: raises $0.50 to $1
Swiss777: folds 
Uncalled bet ($0.50) returned to DSOR65
DSOR65 collected $1.15 from pot
*** SUMMARY ***
Total pot $1.15 | Rake $0 
Seat 1: Gles65 folded before Flop (didn't bet)
Seat 2: Swiss777 (button) folded before Flop
Seat 3: StifflerPL (small blind) folded before Flop
Seat 4: k1tt9nM1nd (big blind) folded before Flop
Seat 5: DSOR65 collected ($1.15)
Seat 6: Hero folded before Flop (didn't bet)



PokerStars Game #35824768358:  Hold'em No Limit ($0.05/$0.10 USD) - 2009/11/25 6:52:18 ET
Table 'May IV' 6-max Seat #3 is the button
Seat 1: Gles65 ($11.95 in chips) 
Seat 2: Swiss777 ($11.60 in chips) 
Seat 3: StifflerPL ($10.20 in chips) 
Seat 4: k1tt9nM1nd ($14.90 in chips) 
Seat 5: DSOR65 ($5.70 in chips) 
Seat 6: Hero ($22 in chips) 
k1tt9nM1nd: posts small blind $0.05
DSOR65: posts big blind $0.10
*** HOLE CARDS ***
Dealt to Hero [Kd 5c]
Hero: folds 
Gles65: folds 
Swiss777: folds 
StifflerPL: folds 
k1tt9nM1nd: folds 
Uncalled bet ($0.05) returned to DSOR65
DSOR65 collected $0.10 from pot
*** SUMMARY ***
Total pot $0.10 | Rake $0 
Seat 1: Gles65 folded before Flop (didn't bet)
Seat 2: Swiss777 folded before Flop (didn't bet)
Seat 3: StifflerPL (button) folded before Flop (didn't bet)
Seat 4: k1tt9nM1nd (small blind) folded before Flop
Seat 5: DSOR65 (big blind) collected ($0.10)
Seat 6: Hero folded before Flop (didn't bet)



PokerStars Game #35824777248:  Hold'em No Limit ($0.05/$0.10 USD) - 2009/11/25 6:52:43 ET
Table 'May IV' 6-max Seat #4 is the button
Seat 1: Gles65 ($11.95 in chips) 
Seat 2: Swiss777 ($11.60 in chips) 
Seat 3: StifflerPL ($10.20 in chips) 
Seat 4: k1tt9nM1nd ($14.85 in chips) 
Seat 5: DSOR65 ($5.75 in chips) 
Seat 6: Hero ($22 in chips) 
DSOR65: posts small blind $0.05
Hero: posts big blind $0.10
*** HOLE CARDS ***
Dealt to Hero [3c Jc]
Gles65: folds 
Swiss777: folds 
StifflerPL: calls $0.10
k1tt9nM1nd: folds 
DSOR65: calls $0.05
Hero: checks 
*** FLOP *** [Ah Ts 2d]
DSOR65: checks 
Hero: checks 
StifflerPL: bets $0.20
DSOR65: folds 
Hero: folds 
Uncalled bet ($0.20) returned to StifflerPL
StifflerPL collected $0.30 from pot
StifflerPL: doesn't show hand 
*** SUMMARY ***
Total pot $0.30 | Rake $0 
Board [Ah Ts 2d]
Seat 1: Gles65 folded before Flop (didn't bet)
Seat 2: Swiss777 folded before Flop (didn't bet)
Seat 3: StifflerPL collected ($0.30)
Seat 4: k1tt9nM1nd (button) folded before Flop (didn't bet)
Seat 5: DSOR65 (small blind) folded on the Flop
Seat 6: Hero (big blind) folded on the Flop



PokerStars Game #35824788702:  Hold'em No Limit ($0.05/$0.10 USD) - 2009/11/25 6:53:15 ET
Table 'May IV' 6-max Seat #5 is the button
Seat 1: Gles65 ($11.95 in chips) 
Seat 2: Swiss777 ($11.60 in chips) 
Seat 3: StifflerPL ($10.40 in chips) 
Seat 4: k1tt9nM1nd ($14.85 in chips) 
Seat 5: DSOR65 ($5.65 in chips) 
Seat 6: Hero ($21.90 in chips) 
Hero: posts small blind $0.05
Gles65: posts big blind $0.10
*** HOLE CARDS ***
Dealt to Hero [Kh 4d]
Swiss777: folds 
StifflerPL: folds 
k1tt9nM1nd: folds 
DSOR65: folds 
Hero: folds 
Uncalled bet ($0.05) returned to Gles65
Gles65 collected $0.10 from pot
Gles65: doesn't show hand 
*** SUMMARY ***
Total pot $0.10 | Rake $0 
Seat 1: Gles65 (big blind) collected ($0.10)
Seat 2: Swiss777 folded before Flop (didn't bet)
Seat 3: StifflerPL folded before Flop (didn't bet)
Seat 4: k1tt9nM1nd folded before Flop (didn't bet)
Seat 5: DSOR65 (button) folded before Flop (didn't bet)
Seat 6: Hero (small blind) folded before Flop



PokerStars Game #35824794475:  Hold'em No Limit ($0.05/$0.10 USD) - 2009/11/25 6:53:31 ET
Table 'May IV' 6-max Seat #6 is the button
Seat 1: Gles65 ($12 in chips) 
Seat 2: Swiss777 ($11.60 in chips) 
Seat 3: StifflerPL ($10.40 in chips) 
Seat 4: k1tt9nM1nd ($14.85 in chips) 
Seat 5: DSOR65 ($5.65 in chips) 
Seat 6: Hero ($21.85 in chips) 
Gles65: posts small blind $0.05
Swiss777: posts big blind $0.10
*** HOLE CARDS ***
Dealt to Hero [Ac 5h]
StifflerPL: folds 
k1tt9nM1nd: folds 
DSOR65: folds 
Hero: raises $0.20 to $0.30
Gles65: folds 
Swiss777: folds 
Uncalled bet ($0.20) returned to Hero
Hero collected $0.25 from pot
*** SUMMARY ***
Total pot $0.25 | Rake $0 
Seat 1: Gles65 (small blind) folded before Flop
Seat 2: Swiss777 (big blind) folded before Flop
Seat 3: StifflerPL folded before Flop (didn't bet)
Seat 4: k1tt9nM1nd folded before Flop (didn't bet)
Seat 5: DSOR65 folded before Flop (didn't bet)
Seat 6: Hero (button) collected ($0.25)



PokerStars Game #35824800852:  Hold'em No Limit ($0.05/$0.10 USD) - 2009/11/25 6:53:49 ET
Table 'May IV' 6-max Seat #1 is the button
Seat 1: Gles65 ($11.95 in chips) 
Seat 2: Swiss777 ($11.50 in chips) 
Seat 3: StifflerPL ($10.40 in chips) 
Seat 4: k1tt9nM1nd ($14.85 in chips) 
Seat 5: DSOR65 ($5.65 in chips) 
Seat 6: Hero ($22 in chips) 
Swiss777: posts small blind $0.05
StifflerPL: posts big blind $0.10
*** HOLE CARDS ***
Dealt to Hero [3s Js]
k1tt9nM1nd: folds 
DSOR65: folds 
Hero: folds 
Gles65: folds 
Swiss777: folds 
Uncalled bet ($0.05) returned to StifflerPL
StifflerPL collected $0.10 from pot
StifflerPL: doesn't show hand 
StifflerPL leaves the table
*** SUMMARY ***
Total pot $0.10 | Rake $0 
Seat 1: Gles65 (button) folded before Flop (didn't bet)
Seat 2: Swiss777 (small blind) folded before Flop
Seat 3: StifflerPL (big blind) collected ($0.10)
Seat 4: k1tt9nM1nd folded before Flop (didn't bet)
Seat 5: DSOR65 folded before Flop (didn't bet)
Seat 6: Hero folded before Flop (didn't bet)



PokerStars Game #35824808528:  Hold'em No Limit ($0.05/$0.10 USD) - 2009/11/25 6:54:10 ET
Table 'May IV' 6-max Seat #2 is the button
Seat 1: Gles65 ($11.95 in chips) 
Seat 2: Swiss777 ($11.45 in chips) 
Seat 4: k1tt9nM1nd ($14.85 in chips) 
Seat 5: DSOR65 ($5.65 in chips) 
Seat 6: Hero ($22 in chips) 
k1tt9nM1nd: posts small blind $0.05
DSOR65: posts big blind $0.10
*** HOLE CARDS ***
Dealt to Hero [6h 9h]
Hero: folds 
Gles65: folds 
Swiss777: folds 
k1tt9nM1nd: folds 
Uncalled bet ($0.05) returned to DSOR65
DSOR65 collected $0.10 from pot
*** SUMMARY ***
Total pot $0.10 | Rake $0 
Seat 1: Gles65 folded before Flop (didn't bet)
Seat 2: Swiss777 (button) folded before Flop (didn't bet)
Seat 4: k1tt9nM1nd (small blind) folded before Flop
Seat 5: DSOR65 (big blind) collected ($0.10)
Seat 6: Hero folded before Flop (didn't bet)



PokerStars Game #35824814084:  Hold'em No Limit ($0.05/$0.10 USD) - 2009/11/25 6:54:26 ET
Table 'May IV' 6-max Seat #4 is the button
Seat 1: Gles65 ($11.95 in chips) 
Seat 2: Swiss777 ($11.45 in chips) 
Seat 4: k1tt9nM1nd ($14.80 in chips) 
Seat 5: DSOR65 ($5.70 in chips) 
Seat 6: Hero ($22 in chips) 
DSOR65: posts small blind $0.05
Hero: posts big blind $0.10
*** HOLE CARDS ***
Dealt to Hero [Kc 9s]
Gles65: folds 
Swiss777: folds 
k1tt9nM1nd: raises $0.20 to $0.30
DSOR65: calls $0.25
Hero: calls $0.20
*** FLOP *** [6h Ad 5h]
ChrVo joins the table at seat #3 
DSOR65: checks 
Hero: checks 
k1tt9nM1nd: bets $0.70
DSOR65: folds 
Hero: folds 
Uncalled bet ($0.70) returned to k1tt9nM1nd
k1tt9nM1nd collected $0.90 from pot
*** SUMMARY ***
Total pot $0.90 | Rake $0 
Board [6h Ad 5h]
Seat 1: Gles65 folded before Flop (didn't bet)
Seat 2: Swiss777 folded before Flop (didn't bet)
Seat 4: k1tt9nM1nd (button) collected ($0.90)
Seat 5: DSOR65 (small blind) folded on the Flop
Seat 6: Hero (big blind) folded on the Flop



PokerStars Game #35824834814:  Hold'em No Limit ($0.05/$0.10 USD) - 2009/11/25 6:55:28 ET
Table 'May IV' 6-max Seat #5 is the button
Seat 1: Gles65 ($11.95 in chips) 
Seat 2: Swiss777 ($11.45 in chips) 
Seat 3: ChrVo ($10 in chips) 
Seat 4: k1tt9nM1nd ($15.40 in chips) 
Seat 5: DSOR65 ($5.40 in chips) 
Seat 6: Hero ($21.70 in chips) 
Hero: posts small blind $0.05
Gles65: posts big blind $0.10
ChrVo: posts big blind $0.10
*** HOLE CARDS ***
Dealt to Hero [9c Ts]
Swiss777: folds 
ChrVo: checks 
k1tt9nM1nd: folds 
DSOR65: calls $0.10
Hero: folds 
Gles65: checks 
*** FLOP *** [8s Ks 4c]
Gles65: checks 
ChrVo: checks 
DSOR65: checks 
*** TURN *** [8s Ks 4c] [3c]
Gles65: checks 
ChrVo: checks 
DSOR65: bets $0.20
Gles65: folds 
ChrVo: folds 
Uncalled bet ($0.20) returned to DSOR65
DSOR65 collected $0.35 from pot
*** SUMMARY ***
Total pot $0.35 | Rake $0 
Board [8s Ks 4c 3c]
Seat 1: Gles65 (big blind) folded on the Turn
Seat 2: Swiss777 folded before Flop (didn't bet)
Seat 3: ChrVo folded on the Turn
Seat 4: k1tt9nM1nd folded before Flop (didn't bet)
Seat 5: DSOR65 (button) collected ($0.35)
Seat 6: Hero (small blind) folded before Flop



PokerStars Game #35824849196:  Hold'em No Limit ($0.05/$0.10 USD) - 2009/11/25 6:56:22 ET
Table 'May IV' 6-max Seat #6 is the button
Seat 1: Gles65 ($11.85 in chips) 
Seat 2: Swiss777 ($11.45 in chips) 
Seat 3: ChrVo ($9.90 in chips) 
Seat 4: k1tt9nM1nd ($15.40 in chips) 
Seat 5: DSOR65 ($5.65 in chips) 
Seat 6: Hero ($21.65 in chips) 
Gles65: posts small blind $0.05
Swiss777: posts big blind $0.10
*** HOLE CARDS ***
Dealt to Hero [Qs 9h]
ChrVo: calls $0.10
k1tt9nM1nd: folds 
DSOR65: folds 
Hero: raises $0.20 to $0.30
Gles65: folds 
Swiss777: folds 
ChrVo: calls $0.20
*** FLOP *** [8h Ad Kh]
ChrVo: bets $0.60
Hero: folds 
Uncalled bet ($0.60) returned to ChrVo
ChrVo collected $0.75 from pot
ChrVo: doesn't show hand 
*** SUMMARY ***
Total pot $0.75 | Rake $0 
Board [8h Ad Kh]
Seat 1: Gles65 (small blind) folded before Flop
Seat 2: Swiss777 (big blind) folded before Flop
Seat 3: ChrVo collected ($0.75)
Seat 4: k1tt9nM1nd folded before Flop (didn't bet)
Seat 5: DSOR65 folded before Flop (didn't bet)
Seat 6: Hero (button) folded on the Flop



PokerStars Game #35824863053:  Hold'em No Limit ($0.05/$0.10 USD) - 2009/11/25 6:57:13 ET
Table 'May IV' 6-max Seat #1 is the button
Seat 1: Gles65 ($11.80 in chips) 
Seat 2: Swiss777 ($11.35 in chips) 
Seat 3: ChrVo ($10.35 in chips) 
Seat 4: k1tt9nM1nd ($15.40 in chips) 
Seat 5: DSOR65 ($5.65 in chips) 
Seat 6: Hero ($21.35 in chips) 
Swiss777: posts small blind $0.05
ChrVo: posts big blind $0.10
*** HOLE CARDS ***
Dealt to Hero [Ks Jc]
k1tt9nM1nd: folds 
DSOR65: folds 
Hero: folds 
Gles65 has timed out
Gles65: folds 
Gles65 is sitting out
Swiss777: folds 
Uncalled bet ($0.05) returned to ChrVo
Gles65 has returned
ChrVo collected $0.10 from pot
ChrVo: doesn't show hand 
*** SUMMARY ***
Total pot $0.10 | Rake $0 
Seat 1: Gles65 (button) folded before Flop (didn't bet)
Seat 2: Swiss777 (small blind) folded before Flop
Seat 3: ChrVo (big blind) collected ($0.10)
Seat 4: k1tt9nM1nd folded before Flop (didn't bet)
Seat 5: DSOR65 folded before Flop (didn't bet)
Seat 6: Hero folded before Flop (didn't bet)



PokerStars Game #35824871750:  Hold'em No Limit ($0.05/$0.10 USD) - 2009/11/25 6:57:44 ET
Table 'May IV' 6-max Seat #2 is the button
Seat 1: Gles65 ($11.80 in chips) 
Seat 2: Swiss777 ($11.30 in chips) 
Seat 3: ChrVo ($10.40 in chips) 
Seat 4: k1tt9nM1nd ($15.40 in chips) 
Seat 5: DSOR65 ($5.65 in chips) 
Seat 6: Hero ($21.35 in chips) 
ChrVo: posts small blind $0.05
k1tt9nM1nd: posts big blind $0.10
*** HOLE CARDS ***
Dealt to Hero [Qs Js]
DSOR65: folds 
Hero: raises $0.20 to $0.30
DSOR65 leaves the table
Gles65: calls $0.30
Swiss777: folds 
ChrVo: calls $0.25
k1tt9nM1nd: folds 
*** FLOP *** [Ad Qd 3h]
ChrVo: bets $0.50
Hero: calls $0.50
Gles65: folds 
*** TURN *** [Ad Qd 3h] [Ts]
ChrVo: bets $1.30
Hero: calls $1.30
*** RIVER *** [Ad Qd 3h Ts] [3s]
ChrVo: bets $3.30
Hero: calls $3.30
*** SHOW DOWN ***
ChrVo: shows [8d Kd] (a pair of Threes)
Hero: shows [Qs Js] (two pair, Queens and Threes)
Hero collected $10.65 from pot
*** SUMMARY ***
Total pot $11.20 | Rake $0.55 
Board [Ad Qd 3h Ts 3s]
Seat 1: Gles65 folded on the Flop
Seat 2: Swiss777 (button) folded before Flop (didn't bet)
Seat 3: ChrVo (small blind) showed [8d Kd] and lost with a pair of Threes
Seat 4: k1tt9nM1nd (big blind) folded before Flop
Seat 5: DSOR65 folded before Flop (didn't bet)
Seat 6: Hero showed [Qs Js] and won ($10.65) with two pair, Queens and Threes



PokerStars Game #35824884993:  Hold'em No Limit ($0.05/$0.10 USD) - 2009/11/25 6:58:32 ET
Table 'May IV' 6-max Seat #3 is the button
Seat 1: Gles65 ($11.50 in chips) 
Seat 2: Swiss777 ($11.30 in chips) 
Seat 3: ChrVo ($5 in chips) 
Seat 4: k1tt9nM1nd ($15.30 in chips) 
Seat 6: Hero ($26.60 in chips) 
k1tt9nM1nd: posts small blind $0.05
Hero: posts big blind $0.10
*** HOLE CARDS ***
Dealt to Hero [Ac 5h]
Gles65: folds 
Swiss777: raises $0.30 to $0.40
ChrVo: folds 
k1tt9nM1nd: folds 
Hero: folds 
Uncalled bet ($0.30) returned to Swiss777
Swiss777 collected $0.25 from pot
Swiss777: doesn't show hand 
*** SUMMARY ***
Total pot $0.25 | Rake $0 
Seat 1: Gles65 folded before Flop (didn't bet)
Seat 2: Swiss777 collected ($0.25)
Seat 3: ChrVo (button) folded before Flop (didn't bet)
Seat 4: k1tt9nM1nd (small blind) folded before Flop
Seat 6: Hero (big blind) folded before Flop



PokerStars Game #35824892605:  Hold'em No Limit ($0.05/$0.10 USD) - 2009/11/25 6:58:59 ET
Table 'May IV' 6-max Seat #4 is the button
Seat 1: Gles65 ($11.50 in chips) 
Seat 2: Swiss777 ($11.45 in chips) 
Seat 3: ChrVo ($5 in chips) 
Seat 4: k1tt9nM1nd ($15.25 in chips) 
Seat 6: Hero ($26.50 in chips) 
Hero: posts small blind $0.05
Gles65: posts big blind $0.10
*** HOLE CARDS ***
Dealt to Hero [As Kc]
Swiss777: folds 
ChrVo: raises $0.20 to $0.30
k1tt9nM1nd: folds 
Hero: raises $0.70 to $1
Gles65: folds 
ChrVo: calls $0.70
*** FLOP *** [4s 2c 2s]
Hero: checks 
ChrVo: bets $1.70
Hero: raises $2.40 to $4.10
ChrVo: calls $2.30 and is all-in
Uncalled bet ($0.10) returned to Hero
*** TURN *** [4s 2c 2s] [Js]
*** RIVER *** [4s 2c 2s Js] [4c]
*** SHOW DOWN ***
Hero: shows [As Kc] (two pair, Fours and Deuces)
ChrVo: shows [Ah 3h] (two pair, Fours and Deuces)
Hero collected $4.80 from pot
ChrVo collected $4.80 from pot
ChrVo leaves the table
*** SUMMARY ***
Total pot $10.10 | Rake $0.50 
Board [4s 2c 2s Js 4c]
Seat 1: Gles65 (big blind) folded before Flop
Seat 2: Swiss777 folded before Flop (didn't bet)
Seat 3: ChrVo showed [Ah 3h] and won ($4.80) with two pair, Fours and Deuces
Seat 4: k1tt9nM1nd (button) folded before Flop (didn't bet)
Seat 6: Hero (small blind) showed [As Kc] and won ($4.80) with two pair, Fours and Deuces



PokerStars Game #35824905650:  Hold'em No Limit ($0.05/$0.10 USD) - 2009/11/25 6:59:46 ET
Table 'May IV' 6-max Seat #6 is the button
Seat 1: Gles65 ($11.40 in chips) 
Seat 2: Swiss777 ($11.45 in chips) 
Seat 4: k1tt9nM1nd ($15.25 in chips) 
Seat 6: Hero ($26.30 in chips) 
Gles65: posts small blind $0.05
Swiss777: posts big blind $0.10
*** HOLE CARDS ***
Dealt to Hero [Qd Js]
k1tt9nM1nd: folds 
Hero: raises $0.20 to $0.30
Gles65: folds 
Swiss777: folds 
Uncalled bet ($0.20) returned to Hero
Hero collected $0.25 from pot
*** SUMMARY ***
Total pot $0.25 | Rake $0 
Seat 1: Gles65 (small blind) folded before Flop
Seat 2: Swiss777 (big blind) folded before Flop
Seat 4: k1tt9nM1nd folded before Flop (didn't bet)
Seat 6: Hero (button) collected ($0.25)



PokerStars Game #35824914646:  Hold'em No Limit ($0.05/$0.10 USD) - 2009/11/25 7:00:18 ET
Table 'May IV' 6-max Seat #1 is the button
Seat 1: Gles65 ($11.35 in chips) 
Seat 2: Swiss777 ($11.35 in chips) 
Seat 4: k1tt9nM1nd ($15.25 in chips) 
Seat 6: Hero ($26.45 in chips) 
Swiss777: posts small blind $0.05
k1tt9nM1nd: posts big blind $0.10
*** HOLE CARDS ***
Dealt to Hero [6d 3d]
Hero: folds 
Gles65: folds 
Swiss777: folds 
Uncalled bet ($0.05) returned to k1tt9nM1nd
k1tt9nM1nd collected $0.10 from pot
*** SUMMARY ***
Total pot $0.10 | Rake $0 
Seat 1: Gles65 (button) folded before Flop (didn't bet)
Seat 2: Swiss777 (small blind) folded before Flop
Seat 4: k1tt9nM1nd (big blind) collected ($0.10)
Seat 6: Hero folded before Flop (didn't bet)



PokerStars Game #35824920369:  Hold'em No Limit ($0.05/$0.10 USD) - 2009/11/25 7:00:38 ET
Table 'May IV' 6-max Seat #2 is the button
Seat 1: Gles65 ($11.35 in chips) 
Seat 2: Swiss777 ($11.30 in chips) 
Seat 4: k1tt9nM1nd ($15.30 in chips) 
Seat 6: Hero ($26.45 in chips) 
k1tt9nM1nd: posts small blind $0.05
Hero: posts big blind $0.10
*** HOLE CARDS ***
Dealt to Hero [2c 5s]
Gles65: calls $0.10
Swiss777: folds 
k1tt9nM1nd: folds 
Hero: checks 
*** FLOP *** [Js Ac 4c]
Patman01 joins the table at seat #5 
Hero: checks 
Gles65: bets $0.20
Hero: folds 
Uncalled bet ($0.20) returned to Gles65
Sr Radío joins the table at seat #3 
Gles65 collected $0.25 from pot
Gles65: doesn't show hand 
*** SUMMARY ***
Total pot $0.25 | Rake $0 
Board [Js Ac 4c]
Seat 1: Gles65 collected ($0.25)
Seat 2: Swiss777 (button) folded before Flop (didn't bet)
Seat 4: k1tt9nM1nd (small blind) folded before Flop
Seat 6: Hero (big blind) folded on the Flop



PokerStars Game #35824931475:  Hold'em No Limit ($0.05/$0.10 USD) - 2009/11/25 7:01:14 ET
Table 'May IV' 6-max Seat #4 is the button
Seat 1: Gles65 ($11.50 in chips) 
Seat 2: Swiss777 ($11.30 in chips) 
Seat 4: k1tt9nM1nd ($15.25 in chips) 
Seat 6: Hero ($26.35 in chips) 
Patman01 will be allowed to play after the button
Hero: posts small blind $0.05
Gles65: posts big blind $0.10
Sr Radío: sits out 
*** HOLE CARDS ***
Dealt to Hero [7c As]
Swiss777: raises $0.30 to $0.40
k1tt9nM1nd: raises $0.90 to $1.30
Hero: folds 
Gles65: folds 
Swiss777: folds 
Uncalled bet ($0.90) returned to k1tt9nM1nd
k1tt9nM1nd collected $0.95 from pot
*** SUMMARY ***
Total pot $0.95 | Rake $0 
Seat 1: Gles65 (big blind) folded before Flop
Seat 2: Swiss777 folded before Flop
Seat 4: k1tt9nM1nd (button) collected ($0.95)
Seat 6: Hero (small blind) folded before Flop



PokerStars Game #35824941074:  Hold'em No Limit ($0.05/$0.10 USD) - 2009/11/25 7:01:44 ET
Table 'May IV' 6-max Seat #6 is the button
Seat 1: Gles65 ($11.40 in chips) 
Seat 2: Swiss777 ($10.90 in chips) 
Seat 4: k1tt9nM1nd ($15.80 in chips) 
Seat 6: Hero ($26.30 in chips) 
Gles65: posts small blind $0.05
Swiss777: posts big blind $0.10
Sr Radío: sits out 
Patman01: sits out 
*** HOLE CARDS ***
Dealt to Hero [3h 5d]
k1tt9nM1nd: folds 
Hero: folds 
Gles65: calls $0.05
Swiss777: checks 
*** FLOP *** [8s 6c Qh]
Gles65: checks 
Swiss777: checks 
*** TURN *** [8s 6c Qh] [Th]
Gles65: bets $0.20
Swiss777: folds 
Uncalled bet ($0.20) returned to Gles65
Gles65 collected $0.20 from pot
Gles65: doesn't show hand 
*** SUMMARY ***
Total pot $0.20 | Rake $0 
Board [8s 6c Qh Th]
Seat 1: Gles65 (small blind) collected ($0.20)
Seat 2: Swiss777 (big blind) folded on the Turn
Seat 4: k1tt9nM1nd folded before Flop (didn't bet)
Seat 6: Hero (button) folded before Flop (didn't bet)



PokerStars Game #35824955156:  Hold'em No Limit ($0.05/$0.10 USD) - 2009/11/25 7:02:26 ET
Table 'May IV' 6-max Seat #1 is the button
Seat 1: Gles65 ($11.50 in chips) 
Seat 2: Swiss777 ($10.80 in chips) 
Seat 3: Sr Radío ($2 in chips) 
Seat 4: k1tt9nM1nd ($15.80 in chips) 
Seat 6: Hero ($26.30 in chips) 
Swiss777: posts small blind $0.05
Sr Radío: posts big blind $0.10
Patman01: sits out 
*** HOLE CARDS ***
Dealt to Hero [Jh 6d]
k1tt9nM1nd: folds 
Hero: folds 
Gles65: folds 
Swiss777: folds 
Uncalled bet ($0.05) returned to Sr Radío
Sr Radío collected $0.10 from pot
Sr Radío: doesn't show hand 
*** SUMMARY ***
Total pot $0.10 | Rake $0 
Seat 1: Gles65 (button) folded before Flop (didn't bet)
Seat 2: Swiss777 (small blind) folded before Flop
Seat 3: Sr Radío (big blind) collected ($0.10)
Seat 4: k1tt9nM1nd folded before Flop (didn't bet)
Seat 6: Hero folded before Flop (didn't bet)



PokerStars Game #35824960551:  Hold'em No Limit ($0.05/$0.10 USD) - 2009/11/25 7:02:42 ET
Table 'May IV' 6-max Seat #2 is the button
Seat 1: Gles65 ($11.50 in chips) 
Seat 2: Swiss777 ($10.75 in chips) 
Seat 3: Sr Radío ($2.05 in chips) 
Seat 4: k1tt9nM1nd ($15.80 in chips) 
Seat 6: Hero ($26.30 in chips) 
Sr Radío: posts small blind $0.05
k1tt9nM1nd: posts big blind $0.10
Patman01: sits out 
*** HOLE CARDS ***
Dealt to Hero [7c Qh]
Hero: folds 
Gles65: folds 
Swiss777: folds 
Sr Radío: calls $0.05
k1tt9nM1nd: checks 
*** FLOP *** [Qs Td Ad]
Sr Radío: checks 
k1tt9nM1nd: bets $0.20
Sr Radío: calls $0.20
*** TURN *** [Qs Td Ad] [3d]
Sr Radío: checks 
k1tt9nM1nd: checks 
*** RIVER *** [Qs Td Ad 3d] [3s]
Sr Radío: checks 
k1tt9nM1nd: checks 
*** SHOW DOWN ***
Sr Radío: shows [Js 8s] (a pair of Threes)
k1tt9nM1nd: shows [2c 2s] (two pair, Threes and Deuces)
k1tt9nM1nd collected $0.60 from pot
*** SUMMARY ***
Total pot $0.60 | Rake $0 
Board [Qs Td Ad 3d 3s]
Seat 1: Gles65 folded before Flop (didn't bet)
Seat 2: Swiss777 (button) folded before Flop (didn't bet)
Seat 3: Sr Radío (small blind) showed [Js 8s] and lost with a pair of Threes
Seat 4: k1tt9nM1nd (big blind) showed [2c 2s] and won ($0.60) with two pair, Threes and Deuces
Seat 6: Hero folded before Flop (didn't bet)



PokerStars Game #35824978334:  Hold'em No Limit ($0.05/$0.10 USD) - 2009/11/25 7:03:33 ET
Table 'May IV' 6-max Seat #3 is the button
Seat 1: Gles65 ($11.50 in chips) 
Seat 2: Swiss777 ($10.75 in chips) 
Seat 3: Sr Radío ($2 in chips) 
Seat 4: k1tt9nM1nd ($16.10 in chips) 
Seat 5: Patman01 ($10 in chips) 
Seat 6: Hero ($26.30 in chips) 
k1tt9nM1nd: posts small blind $0.05
Patman01: posts big blind $0.10
*** HOLE CARDS ***
Dealt to Hero [Qd 7c]
Hero: folds 
Gles65: folds 
Swiss777: folds 
Sr Radío: raises $0.15 to $0.25
k1tt9nM1nd: folds 
Patman01: folds 
Uncalled bet ($0.15) returned to Sr Radío
Sr Radío collected $0.25 from pot
Sr Radío: doesn't show hand 
*** SUMMARY ***
Total pot $0.25 | Rake $0 
Seat 1: Gles65 folded before Flop (didn't bet)
Seat 2: Swiss777 folded before Flop (didn't bet)
Seat 3: Sr Radío (button) collected ($0.25)
Seat 4: k1tt9nM1nd (small blind) folded before Flop
Seat 5: Patman01 (big blind) folded before Flop
Seat 6: Hero folded before Flop (didn't bet)



PokerStars Game #35824985031:  Hold'em No Limit ($0.05/$0.10 USD) - 2009/11/25 7:03:51 ET
Table 'May IV' 6-max Seat #4 is the button
Seat 1: Gles65 ($11.50 in chips) 
Seat 2: Swiss777 ($10.75 in chips) 
Seat 3: Sr Radío ($2.15 in chips) 
Seat 4: k1tt9nM1nd ($16.05 in chips) 
Seat 5: Patman01 ($10 in chips) 
Seat 6: Hero ($26.30 in chips) 
Patman01: posts small blind $0.05
Hero: posts big blind $0.10
*** HOLE CARDS ***
Dealt to Hero [Qh 8h]
Gles65: folds 
Swiss777: folds 
Sr Radío: folds 
k1tt9nM1nd: folds 
Patman01: calls $0.05
Hero: checks 
*** FLOP *** [9d Qs 3h]
k1tt9nM1nd leaves the table
Patman01: checks 
Hero: checks 
*** TURN *** [9d Qs 3h] [Kc]
Patman01: checks 
Hero: bets $0.20
Patman01: folds 
Uncalled bet ($0.20) returned to Hero
Hero collected $0.20 from pot
*** SUMMARY ***
Total pot $0.20 | Rake $0 
Board [9d Qs 3h Kc]
Seat 1: Gles65 folded before Flop (didn't bet)
Seat 2: Swiss777 folded before Flop (didn't bet)
Seat 3: Sr Radío folded before Flop (didn't bet)
Seat 4: k1tt9nM1nd (button) folded before Flop (didn't bet)
Seat 5: Patman01 (small blind) folded on the Turn
Seat 6: Hero (big blind) collected ($0.20)



PokerStars Game #35825014830:  Hold'em No Limit ($0.05/$0.10 USD) - 2009/11/25 7:05:13 ET
Table 'May IV' 6-max Seat #5 is the button
Seat 1: Gles65 ($11.50 in chips) 
Seat 2: Swiss777 ($10.75 in chips) 
Seat 3: Sr Radío ($2.15 in chips) 
Seat 5: Patman01 ($10 in chips) 
Seat 6: Hero ($26.40 in chips) 
Hero: posts small blind $0.05
Gles65: posts big blind $0.10
*** HOLE CARDS ***
Dealt to Hero [7h 8d]
Swiss777: raises $0.30 to $0.40
Sr Radío: folds 
Patman01: folds 
Hero: folds 
Gles65: folds 
Uncalled bet ($0.30) returned to Swiss777
Swiss777 collected $0.25 from pot
Swiss777: doesn't show hand 
*** SUMMARY ***
Total pot $0.25 | Rake $0 
Seat 1: Gles65 (big blind) folded before Flop
Seat 2: Swiss777 collected ($0.25)
Seat 3: Sr Radío folded before Flop (didn't bet)
Seat 5: Patman01 (button) folded before Flop (didn't bet)
Seat 6: Hero (small blind) folded before Flop



PokerStars Game #35825024629:  Hold'em No Limit ($0.05/$0.10 USD) - 2009/11/25 7:05:39 ET
Table 'May IV' 6-max Seat #6 is the button
Seat 1: Gles65 ($11.40 in chips) 
Seat 2: Swiss777 ($10.90 in chips) 
Seat 3: Sr Radío ($2.15 in chips) 
Seat 5: Patman01 ($10 in chips) 
Seat 6: Hero ($26.35 in chips) 
Gles65: posts small blind $0.05
Swiss777: posts big blind $0.10
*** HOLE CARDS ***
Dealt to Hero [4d 6h]
Sr Radío: raises $0.15 to $0.25
Patman01: folds 
Hero: folds 
Gles65: folds 
Swiss777: folds 
Uncalled bet ($0.15) returned to Sr Radío
Sr Radío collected $0.25 from pot
Sr Radío: doesn't show hand 
*** SUMMARY ***
Total pot $0.25 | Rake $0 
Seat 1: Gles65 (small blind) folded before Flop
Seat 2: Swiss777 (big blind) folded before Flop
Seat 3: Sr Radío collected ($0.25)
Seat 5: Patman01 folded before Flop (didn't bet)
Seat 6: Hero (button) folded before Flop (didn't bet)



PokerStars Game #35825030435:  Hold'em No Limit ($0.05/$0.10 USD) - 2009/11/25 7:05:55 ET
Table 'May IV' 6-max Seat #1 is the button
Seat 1: Gles65 ($11.35 in chips) 
Seat 2: Swiss777 ($10.80 in chips) 
Seat 3: Sr Radío ($2.30 in chips) 
Seat 5: Patman01 ($10 in chips) 
Seat 6: Hero ($26.35 in chips) 
Swiss777: posts small blind $0.05
Sr Radío: posts big blind $0.10
*** HOLE CARDS ***
Dealt to Hero [Ts 5c]
Patman01: folds 
Hero: folds 
Gles65: folds 
Swiss777: folds 
Uncalled bet ($0.05) returned to Sr Radío
Sr Radío collected $0.10 from pot
Sr Radío: doesn't show hand 
*** SUMMARY ***
Total pot $0.10 | Rake $0 
Seat 1: Gles65 (button) folded before Flop (didn't bet)
Seat 2: Swiss777 (small blind) folded before Flop
Seat 3: Sr Radío (big blind) collected ($0.10)
Seat 5: Patman01 folded before Flop (didn't bet)
Seat 6: Hero folded before Flop (didn't bet)



PokerStars Game #35825035088:  Hold'em No Limit ($0.05/$0.10 USD) - 2009/11/25 7:06:08 ET
Table 'May IV' 6-max Seat #2 is the button
Seat 1: Gles65 ($11.35 in chips) 
Seat 2: Swiss777 ($10.75 in chips) 
Seat 3: Sr Radío ($2.35 in chips) 
Seat 5: Patman01 ($10 in chips) 
Seat 6: Hero ($26.35 in chips) 
Sr Radío: posts small blind $0.05
Patman01: posts big blind $0.10
*** HOLE CARDS ***
Dealt to Hero [9h Ts]
Hero: folds 
Gles65: folds 
Swiss777: folds 
Sr Radío: folds 
Uncalled bet ($0.05) returned to Patman01
Patman01 collected $0.10 from pot
Patman01: doesn't show hand 
*** SUMMARY ***
Total pot $0.10 | Rake $0 
Seat 1: Gles65 folded before Flop (didn't bet)
Seat 2: Swiss777 (button) folded before Flop (didn't bet)
Seat 3: Sr Radío (small blind) folded before Flop
Seat 5: Patman01 (big blind) collected ($0.10)
Seat 6: Hero folded before Flop (didn't bet)



PokerStars Game #35825044906:  Hold'em No Limit ($0.05/$0.10 USD) - 2009/11/25 7:06:35 ET
Table 'May IV' 6-max Seat #3 is the button
Seat 1: Gles65 ($11.35 in chips) 
Seat 2: Swiss777 ($10.75 in chips) 
Seat 3: Sr Radío ($2.30 in chips) 
Seat 5: Patman01 ($10.05 in chips) 
Seat 6: Hero ($26.35 in chips) 
Patman01: posts small blind $0.05
Hero: posts big blind $0.10
*** HOLE CARDS ***
Dealt to Hero [4s Qd]
espanol63 joins the table at seat #4 
Gles65 has timed out
Gles65: folds 
Gles65 is sitting out
Swiss777: folds 
Gles65 has returned
Sr Radío: raises $0.15 to $0.25
Patman01: folds 
Hero: folds 
Uncalled bet ($0.15) returned to Sr Radío
Sr Radío collected $0.25 from pot
Sr Radío: doesn't show hand 
*** SUMMARY ***
Total pot $0.25 | Rake $0 
Seat 1: Gles65 folded before Flop (didn't bet)
Seat 2: Swiss777 folded before Flop (didn't bet)
Seat 3: Sr Radío (button) collected ($0.25)
Seat 5: Patman01 (small blind) folded before Flop
Seat 6: Hero (big blind) folded before Flop



PokerStars Game #35825057094:  Hold'em No Limit ($0.05/$0.10 USD) - 2009/11/25 7:07:09 ET
Table 'May IV' 6-max Seat #5 is the button
Seat 1: Gles65 ($11.35 in chips) 
Seat 2: Swiss777 ($10.75 in chips) 
Seat 3: Sr Radío ($2.45 in chips) 
Seat 5: Patman01 ($10 in chips) 
Seat 6: Hero ($26.25 in chips) 
Hero: posts small blind $0.05
Gles65: posts big blind $0.10
espanol63: sits out 
*** HOLE CARDS ***
Dealt to Hero [9d Qc]
Swiss777: folds 
Sr Radío: folds 
Patman01: folds 
Hero: calls $0.05
Gles65: checks 
*** FLOP *** [9h 5c Jd]
Hero: checks 
Gles65: checks 
*** TURN *** [9h 5c Jd] [5d]
Hero: bets $0.30
Gles65: folds 
Uncalled bet ($0.30) returned to Hero
Hero collected $0.20 from pot
*** SUMMARY ***
Total pot $0.20 | Rake $0 
Board [9h 5c Jd 5d]
Seat 1: Gles65 (big blind) folded on the Turn
Seat 2: Swiss777 folded before Flop (didn't bet)
Seat 3: Sr Radío folded before Flop (didn't bet)
Seat 5: Patman01 (button) folded before Flop (didn't bet)
Seat 6: Hero (small blind) collected ($0.20)



PokerStars Game #35825075553:  Hold'em No Limit ($0.05/$0.10 USD) - 2009/11/25 7:08:00 ET
Table 'May IV' 6-max Seat #6 is the button
Seat 1: Gles65 ($11.25 in chips) 
Seat 2: Swiss777 ($10.75 in chips) 
Seat 3: Sr Radío ($2.45 in chips) 
Seat 5: Patman01 ($10 in chips) 
Seat 6: Hero ($26.35 in chips) 
Gles65: posts small blind $0.05
Swiss777: posts big blind $0.10
espanol63: sits out 
*** HOLE CARDS ***
Dealt to Hero [3s 2d]
Sr Radío: folds 
Patman01: folds 
Hero: folds 
Gles65: calls $0.05
Swiss777: checks 
*** FLOP *** [Ad 7h Jh]
Gles65: checks 
Swiss777: checks 
*** TURN *** [Ad 7h Jh] [7d]
Gles65: checks 
Swiss777: checks 
*** RIVER *** [Ad 7h Jh 7d] [Qs]
Gles65: checks 
Swiss777: checks 
*** SHOW DOWN ***
Gles65: shows [9c Kc] (a pair of Sevens)
Swiss777: mucks hand 
Gles65 collected $0.20 from pot
*** SUMMARY ***
Total pot $0.20 | Rake $0 
Board [Ad 7h Jh 7d Qs]
Seat 1: Gles65 (small blind) showed [9c Kc] and won ($0.20) with a pair of Sevens
Seat 2: Swiss777 (big blind) mucked [8d 6s]
Seat 3: Sr Radío folded before Flop (didn't bet)
Seat 5: Patman01 folded before Flop (didn't bet)
Seat 6: Hero (button) folded before Flop (didn't bet)



PokerStars Game #35825091438:  Hold'em No Limit ($0.05/$0.10 USD) - 2009/11/25 7:08:44 ET
Table 'May IV' 6-max Seat #1 is the button
Seat 1: Gles65 ($11.35 in chips) 
Seat 2: Swiss777 ($10.65 in chips) 
Seat 4: espanol63 ($10 in chips) 
Seat 5: Patman01 ($10 in chips) 
Seat 6: Hero ($26.35 in chips) 
Swiss777: posts small blind $0.05
Sr Radío: is sitting out 
espanol63: posts big blind $0.10
*** HOLE CARDS ***
Dealt to Hero [8c Qd]
Patman01: folds 
Hero: folds 
Sr Radío has returned
Sr Radío leaves the table
Gles65: raises $0.30 to $0.40
Swiss777: folds 
espanol63: calls $0.30
*** FLOP *** [Jd 6d 7s]
espanol63: bets $0.50
Andrey_UKRNA joins the table at seat #3 
Gles65: raises $1 to $1.50
espanol63: calls $1
*** TURN *** [Jd 6d 7s] [3d]
espanol63: checks 
Gles65: checks 
*** RIVER *** [Jd 6d 7s 3d] [Ah]
espanol63: checks 
Gles65: bets $3.70
espanol63: folds 
Uncalled bet ($3.70) returned to Gles65
Gles65 collected $3.70 from pot
Gles65: doesn't show hand 
*** SUMMARY ***
Total pot $3.85 | Rake $0.15 
Board [Jd 6d 7s 3d Ah]
Seat 1: Gles65 (button) collected ($3.70)
Seat 2: Swiss777 (small blind) folded before Flop
Seat 4: espanol63 (big blind) folded on the River
Seat 5: Patman01 folded before Flop (didn't bet)
Seat 6: Hero folded before Flop (didn't bet)



PokerStars Game #35825126395:  Hold'em No Limit ($0.05/$0.10 USD) - 2009/11/25 7:10:21 ET
Table 'May IV' 6-max Seat #2 is the button
Seat 1: Gles65 ($13.15 in chips) 
Seat 2: Swiss777 ($10.60 in chips) 
Seat 4: espanol63 ($8.10 in chips) 
Seat 5: Patman01 ($10 in chips) 
Seat 6: Hero ($26.35 in chips) 
Andrey_UKRNA will be allowed to play after the button
espanol63: posts small blind $0.05
Patman01: posts big blind $0.10
*** HOLE CARDS ***
Dealt to Hero [5s 5d]
Hero: raises $0.20 to $0.30
Gles65: raises $0.60 to $0.90
Swiss777: folds 
espanol63: folds 
Patman01: folds 
Hero: calls $0.60
*** FLOP *** [Tc Td Ad]
Hero: checks 
Gles65: checks 
*** TURN *** [Tc Td Ad] [7h]
Hero: checks 
Gles65: bets $1.20
Hero: calls $1.20
*** RIVER *** [Tc Td Ad 7h] [6s]
Hero: checks 
Gles65: checks 
*** SHOW DOWN ***
Hero: shows [5s 5d] (two pair, Tens and Fives)
Gles65: shows [Jh Js] (two pair, Jacks and Tens)
Gles65 collected $4.15 from pot
*** SUMMARY ***
Total pot $4.35 | Rake $0.20 
Board [Tc Td Ad 7h 6s]
Seat 1: Gles65 showed [Jh Js] and won ($4.15) with two pair, Jacks and Tens
Seat 2: Swiss777 (button) folded before Flop (didn't bet)
Seat 4: espanol63 (small blind) folded before Flop
Seat 5: Patman01 (big blind) folded before Flop
Seat 6: Hero showed [5s 5d] and lost with two pair, Tens and Fives



PokerStars Game #35825152132:  Hold'em No Limit ($0.05/$0.10 USD) - 2009/11/25 7:11:31 ET
Table 'May IV' 6-max Seat #4 is the button
Seat 1: Gles65 ($15.20 in chips) 
Seat 2: Swiss777 ($10.60 in chips) 
Seat 3: Andrey_UKRNA ($6 in chips) 
Seat 4: espanol63 ($8.05 in chips) 
Seat 5: Patman01 ($10 in chips) 
Seat 6: Hero ($24.25 in chips) 
Patman01: posts small blind $0.05
Hero: posts big blind $0.10
Andrey_UKRNA: posts big blind $0.10
*** HOLE CARDS ***
Dealt to Hero [Kc 4h]
Gles65: folds 
Swiss777: folds 
Andrey_UKRNA: checks 
espanol63: folds 
Patman01: folds 
Hero: checks 
*** FLOP *** [3h 6d 5c]
Hero: bets $0.20
Andrey_UKRNA: raises $0.20 to $0.40
Hero: calls $0.20
*** TURN *** [3h 6d 5c] [Ts]
Hero: checks 
Andrey_UKRNA: bets $0.40
Hero: calls $0.40
*** RIVER *** [3h 6d 5c Ts] [Ks]
Hero: checks 
Andrey_UKRNA: bets $0.40
Hero: calls $0.40
*** SHOW DOWN ***
Andrey_UKRNA: shows [2s 4d] (a straight, Deuce to Six)
Hero: mucks hand 
Andrey_UKRNA collected $2.55 from pot
*** SUMMARY ***
Total pot $2.65 | Rake $0.10 
Board [3h 6d 5c Ts Ks]
Seat 1: Gles65 folded before Flop (didn't bet)
Seat 2: Swiss777 folded before Flop (didn't bet)
Seat 3: Andrey_UKRNA showed [2s 4d] and won ($2.55) with a straight, Deuce to Six
Seat 4: espanol63 (button) folded before Flop (didn't bet)
Seat 5: Patman01 (small blind) folded before Flop
Seat 6: Hero (big blind) mucked [Kc 4h]



PokerStars Game #35825174865:  Hold'em No Limit ($0.05/$0.10 USD) - 2009/11/25 7:12:34 ET
Table 'May IV' 6-max Seat #5 is the button
Seat 1: Gles65 ($15.20 in chips) 
Seat 2: Swiss777 ($10.60 in chips) 
Seat 3: Andrey_UKRNA ($7.25 in chips) 
Seat 4: espanol63 ($8.05 in chips) 
Seat 5: Patman01 ($10 in chips) 
Seat 6: Hero ($22.95 in chips) 
Hero: posts small blind $0.05
Gles65: posts big blind $0.10
*** HOLE CARDS ***
Dealt to Hero [7d 7h]
Swiss777: folds 
Andrey_UKRNA: folds 
espanol63: folds 
Patman01: folds 
Hero: raises $0.20 to $0.30
Gles65: raises $0.60 to $0.90
Hero: calls $0.60
*** FLOP *** [4d 5s Qc]
Hero: checks 
Gles65: checks 
*** TURN *** [4d 5s Qc] [3c]
Hero: bets $1.60
Gles65: folds 
Uncalled bet ($1.60) returned to Hero
Hero collected $1.75 from pot
*** SUMMARY ***
Total pot $1.80 | Rake $0.05 
Board [4d 5s Qc 3c]
Seat 1: Gles65 (big blind) folded on the Turn
Seat 2: Swiss777 folded before Flop (didn't bet)
Seat 3: Andrey_UKRNA folded before Flop (didn't bet)
Seat 4: espanol63 folded before Flop (didn't bet)
Seat 5: Patman01 (button) folded before Flop (didn't bet)
Seat 6: Hero (small blind) collected ($1.75)



PokerStars Game #35825191279:  Hold'em No Limit ($0.05/$0.10 USD) - 2009/11/25 7:13:19 ET
Table 'May IV' 6-max Seat #6 is the button
Seat 1: Gles65 ($14.30 in chips) 
Seat 2: Swiss777 ($10.60 in chips) 
Seat 3: Andrey_UKRNA ($7.25 in chips) 
Seat 4: espanol63 ($8.05 in chips) 
Seat 5: Patman01 ($10 in chips) 
Seat 6: Hero ($23.80 in chips) 
Gles65: posts small blind $0.05
Swiss777: posts big blind $0.10
*** HOLE CARDS ***
Dealt to Hero [4h 2c]
Andrey_UKRNA: folds 
espanol63: raises $0.30 to $0.40
Patman01: folds 
Hero: folds 
Gles65: folds 
Swiss777: folds 
Uncalled bet ($0.30) returned to espanol63
espanol63 collected $0.25 from pot
espanol63: doesn't show hand 
*** SUMMARY ***
Total pot $0.25 | Rake $0 
Seat 1: Gles65 (small blind) folded before Flop
Seat 2: Swiss777 (big blind) folded before Flop
Seat 3: Andrey_UKRNA folded before Flop (didn't bet)
Seat 4: espanol63 collected ($0.25)
Seat 5: Patman01 folded before Flop (didn't bet)
Seat 6: Hero (button) folded before Flop (didn't bet)



PokerStars Game #35825200467:  Hold'em No Limit ($0.05/$0.10 USD) - 2009/11/25 7:13:44 ET
Table 'May IV' 6-max Seat #1 is the button
Seat 1: Gles65 ($14.25 in chips) 
Seat 2: Swiss777 ($10.50 in chips) 
Seat 3: Andrey_UKRNA ($7.25 in chips) 
Seat 4: espanol63 ($8.20 in chips) 
Seat 5: Patman01 ($10 in chips) 
Seat 6: Hero ($23.80 in chips) 
Swiss777: posts small blind $0.05
Andrey_UKRNA: posts big blind $0.10
*** HOLE CARDS ***
Dealt to Hero [8h Tc]
espanol63: calls $0.10
Patman01: raises $0.20 to $0.30
Hero: folds 
Gles65: folds 
Swiss777: folds 
Andrey_UKRNA: folds 
espanol63: calls $0.20
*** FLOP *** [4s 6h 5d]
espanol63: checks 
Patman01: bets $0.40
espanol63: calls $0.40
*** TURN *** [4s 6h 5d] [Ts]
espanol63: checks 
Patman01: bets $0.70
espanol63: calls $0.70
*** RIVER *** [4s 6h 5d Ts] [Ac]
espanol63: checks 
Patman01: checks 
*** SHOW DOWN ***
espanol63: shows [3d 3c] (a pair of Threes)
Patman01: shows [8s 8d] (a pair of Eights)
Patman01 collected $2.85 from pot
*** SUMMARY ***
Total pot $2.95 | Rake $0.10 
Board [4s 6h 5d Ts Ac]
Seat 1: Gles65 (button) folded before Flop (didn't bet)
Seat 2: Swiss777 (small blind) folded before Flop
Seat 3: Andrey_UKRNA (big blind) folded before Flop
Seat 4: espanol63 showed [3d 3c] and lost with a pair of Threes
Seat 5: Patman01 showed [8s 8d] and won ($2.85) with a pair of Eights
Seat 6: Hero folded before Flop (didn't bet)



PokerStars Game #35825214163:  Hold'em No Limit ($0.05/$0.10 USD) - 2009/11/25 7:14:22 ET
Table 'May IV' 6-max Seat #2 is the button
Seat 1: Gles65 ($14.25 in chips) 
Seat 2: Swiss777 ($10.45 in chips) 
Seat 3: Andrey_UKRNA ($7.15 in chips) 
Seat 4: espanol63 ($6.80 in chips) 
Seat 5: Patman01 ($11.45 in chips) 
Seat 6: Hero ($23.80 in chips) 
Andrey_UKRNA: posts small blind $0.05
espanol63: posts big blind $0.10
*** HOLE CARDS ***
Dealt to Hero [9h 2d]
Patman01: folds 
Hero: folds 
Gles65: folds 
Swiss777: raises $0.30 to $0.40
Andrey_UKRNA: folds 
espanol63: folds 
Uncalled bet ($0.30) returned to Swiss777
espanol63 leaves the table
Swiss777 collected $0.25 from pot
Swiss777: doesn't show hand 
*** SUMMARY ***
Total pot $0.25 | Rake $0 
Seat 1: Gles65 folded before Flop (didn't bet)
Seat 2: Swiss777 (button) collected ($0.25)
Seat 3: Andrey_UKRNA (small blind) folded before Flop
Seat 4: espanol63 (big blind) folded before Flop
Seat 5: Patman01 folded before Flop (didn't bet)
Seat 6: Hero folded before Flop (didn't bet)



