PokerStars Game #31900318973:  Hold'em No Limit ($0.01/$0.02 USD) - 2010/05/06 22:46:48 WET [2010/05/06 17:46:48 ET]
Table '99999999' 9-max Seat #5 is the button
Seat 2: Player14 ($0.97 in chips) 
Seat 3: Player23 ($1.53 in chips) 
Seat 4: Hero ($1.60 in chips) 
Seat 5: Player5 ($2.91 in chips) 
Seat 6: Player22 ($2.45 in chips) 
Seat 7: Player19 ($2.56 in chips) 
Seat 8: Player3 ($3.01 in chips) 
Seat 9: Player21 ($0.58 in chips) 
Player22: posts small blind $0.01
Player19: posts big blind $0.02
Hero: posts big blind $0.02
*** HOLE CARDS ***
Dealt to Hero [2d Kc]
Player3: folds 
Player21: folds 
Player14: calls $0.02
Player23: calls $0.02
Hero: checks 
Player5: folds 
Player22: calls $0.01
Player19: checks 
*** FLOP *** [Qh 8d 7s]
Player22: bets $0.06
Player19: folds 
Player14: calls $0.06
Player23: folds 
Hero: folds 
*** TURN *** [Qh 8d 7s] [3s]
Player22: bets $0.30
Player14: folds 
Uncalled bet ($0.30) returned to Player22
Player22 collected $0.22 from pot
Player22: doesn't show hand 
*** SUMMARY ***
Total pot $0.22 | Rake $0 
Board [Qh 8d 7s 3s]
Seat 2: Player14 folded on the Turn
Seat 3: Player23 folded on the Flop
Seat 4: Hero folded on the Flop
Seat 5: Player5 (button) folded before Flop (didn't bet)
Seat 6: Player22 (small blind) collected ($0.22)
Seat 7: Player19 (big blind) folded on the Flop
Seat 8: Player3 folded before Flop (didn't bet)
Seat 9: Player21 folded before Flop (didn't bet)



PokerStars Game #85321652824:  Hold'em No Limit ($0.01/$0.02 USD) - 2010/05/06 22:47:57 WET [2010/05/06 17:47:57 ET]
Table '99999999' 9-max Seat #6 is the button
Seat 2: Player14 ($0.89 in chips) 
Seat 3: Player23 ($1.51 in chips) 
Seat 4: Hero ($1.58 in chips) 
Seat 5: Player5 ($2.91 in chips) 
Seat 6: Player22 ($2.59 in chips) 
Seat 7: Player19 ($2.54 in chips) 
Seat 8: Player3 ($3.01 in chips) 
Seat 9: Player21 ($0.58 in chips) 
Player19: posts small blind $0.01
Player3: posts big blind $0.02
*** HOLE CARDS ***
Dealt to Hero [3h Td]
Player21: folds 
Player14: folds 
Player23: folds 
Hero: folds 
Player5: raises $0.10 to $0.12
Player22: calls $0.12
Player11 joins the table at seat #1 
Player19: folds 
Player3: folds 
*** FLOP *** [Js Qh 9s]
Player5: checks 
Player22: bets $0.25
Player5: folds 
Uncalled bet ($0.25) returned to Player22
Player22 collected $0.27 from pot
Player22: doesn't show hand 
*** SUMMARY ***
Total pot $0.27 | Rake $0 
Board [Js Qh 9s]
Seat 2: Player14 folded before Flop (didn't bet)
Seat 3: Player23 folded before Flop (didn't bet)
Seat 4: Hero folded before Flop (didn't bet)
Seat 5: Player5 folded on the Flop
Seat 6: Player22 (button) collected ($0.27)
Seat 7: Player19 (small blind) folded before Flop
Seat 8: Player3 (big blind) folded before Flop
Seat 9: Player21 folded before Flop (didn't bet)



PokerStars Game #30102275294:  Hold'em No Limit ($0.01/$0.02 USD) - 2010/05/06 22:48:47 WET [2010/05/06 17:48:47 ET]
Table '99999999' 9-max Seat #7 is the button
Seat 2: Player14 ($0.89 in chips) 
Seat 3: Player23 ($1.51 in chips) 
Seat 4: Hero ($1.58 in chips) 
Seat 5: Player5 ($2.79 in chips) 
Seat 6: Player22 ($2.74 in chips) 
Seat 7: Player19 ($2.53 in chips) 
Seat 8: Player3 ($3 in chips) 
Seat 9: Player21 ($0.58 in chips) 
Player3: posts small blind $0.01
Player21: posts big blind $0.02
Player11: sits out 
*** HOLE CARDS ***
Dealt to Hero [Qc 5d]
Player14: folds 
Player23: folds 
Hero: raises $0.04 to $0.06
Player5: folds 
Player22: folds 
Player19: folds 
Player3: folds 
Player21: folds 
Uncalled bet ($0.04) returned to Hero
Hero collected $0.05 from pot
Hero: doesn't show hand 
*** SUMMARY ***
Total pot $0.05 | Rake $0 
Seat 2: Player14 folded before Flop (didn't bet)
Seat 3: Player23 folded before Flop (didn't bet)
Seat 4: Hero collected ($0.05)
Seat 5: Player5 folded before Flop (didn't bet)
Seat 6: Player22 folded before Flop (didn't bet)
Seat 7: Player19 (button) folded before Flop (didn't bet)
Seat 8: Player3 (small blind) folded before Flop
Seat 9: Player21 (big blind) folded before Flop



PokerStars Game #20107261170:  Hold'em No Limit ($0.01/$0.02 USD) - 2010/05/06 22:49:11 WET [2010/05/06 17:49:11 ET]
Table '99999999' 9-max Seat #8 is the button
Seat 1: Player11 ($1.60 in chips) 
Seat 2: Player14 ($0.89 in chips) 
Seat 3: Player23 ($1.51 in chips) 
Seat 4: Hero ($1.61 in chips) 
Seat 5: Player5 ($2.79 in chips) 
Seat 6: Player22 ($2.74 in chips) 
Seat 7: Player19 ($2.53 in chips) 
Seat 8: Player3 ($3 in chips) 
Seat 9: Player21 ($0.56 in chips) 
Player21: posts small blind $0.01
Player11: posts big blind $0.02
*** HOLE CARDS ***
Dealt to Hero [5d Qc]
Player14: folds 
Player23: folds 
Hero: folds 
Player5: folds 
Player22: folds 
Player19: folds 
Player3: folds 
Player21: calls $0.01
Player11: checks 
*** FLOP *** [7s 3s Kd]
Player21: bets $0.02
Player11: folds 
Uncalled bet ($0.02) returned to Player21
Player21 collected $0.04 from pot
Player21: doesn't show hand 
*** SUMMARY ***
Total pot $0.04 | Rake $0 
Board [7s 3s Kd]
Seat 1: Player11 (big blind) folded on the Flop
Seat 2: Player14 folded before Flop (didn't bet)
Seat 3: Player23 folded before Flop (didn't bet)
Seat 4: Hero folded before Flop (didn't bet)
Seat 5: Player5 folded before Flop (didn't bet)
Seat 6: Player22 folded before Flop (didn't bet)
Seat 7: Player19 folded before Flop (didn't bet)
Seat 8: Player3 (button) folded before Flop (didn't bet)
Seat 9: Player21 (small blind) collected ($0.04)



PokerStars Game #30246290211:  Hold'em No Limit ($0.01/$0.02 USD) - 2010/05/06 22:49:41 WET [2010/05/06 17:49:41 ET]
Table '99999999' 9-max Seat #9 is the button
Seat 1: Player11 ($1.58 in chips) 
Seat 2: Player14 ($0.89 in chips) 
Seat 3: Player23 ($1.51 in chips) 
Seat 4: Hero ($1.61 in chips) 
Seat 5: Player5 ($2.79 in chips) 
Seat 6: Player22 ($2.74 in chips) 
Seat 7: Player19 ($2.53 in chips) 
Seat 8: Player3 ($3 in chips) 
Seat 9: Player21 ($0.58 in chips) 
Player11: posts small blind $0.01
Player14: posts big blind $0.02
*** HOLE CARDS ***
Dealt to Hero [8d 7d]
Player23: folds 
Hero: calls $0.02
Player5: folds 
Player22: folds 
Player19: calls $0.02
Player3: folds 
Player21: folds 
Player11: calls $0.01
Player14: checks 
*** FLOP *** [5s 9c 4c]
Player11: bets $0.08
Player14: calls $0.08
Hero: calls $0.08
Player19: folds 
*** TURN *** [5s 9c 4c] [Td]
Player11: bets $0.04
Player14: calls $0.04
Hero: calls $0.04
*** RIVER *** [5s 9c 4c Td] [Kh]
Player11: checks 
Player14: bets $0.10
Hero: folds 
Player11: folds 
Uncalled bet ($0.10) returned to Player14
Player14 collected $0.44 from pot
*** SUMMARY ***
Total pot $0.44 | Rake $0 
Board [5s 9c 4c Td Kh]
Seat 1: Player11 (small blind) folded on the River
Seat 2: Player14 (big blind) collected ($0.44)
Seat 3: Player23 folded before Flop (didn't bet)
Seat 4: Hero folded on the River
Seat 5: Player5 folded before Flop (didn't bet)
Seat 6: Player22 folded before Flop (didn't bet)
Seat 7: Player19 folded on the Flop
Seat 8: Player3 folded before Flop (didn't bet)
Seat 9: Player21 (button) folded before Flop (didn't bet)



PokerStars Game #31761373829:  Hold'em No Limit ($0.01/$0.02 USD) - 2010/05/06 22:51:11 WET [2010/05/06 17:51:11 ET]
Table '99999999' 9-max Seat #1 is the button
Seat 1: Player11 ($1.44 in chips) 
Seat 2: Player14 ($1.19 in chips) 
Seat 3: Player23 ($1.51 in chips) 
Seat 4: Hero ($1.47 in chips) 
Seat 5: Player5 ($2.79 in chips) 
Seat 6: Player22 ($2.74 in chips) 
Seat 7: Player19 ($2.51 in chips) 
Seat 8: Player3 ($3 in chips) 
Seat 9: Player21 ($0.58 in chips) 
Player14: posts small blind $0.01
Player23: posts big blind $0.02
*** HOLE CARDS ***
Dealt to Hero [3s 5d]
Hero: folds 
Player5: folds 
Player22: raises $0.02 to $0.04
Player19: folds 
Player3: folds 
Player21: folds 
Player11: raises $0.14 to $0.18
Player14: folds 
Player23: calls $0.16
Player22: calls $0.14
*** FLOP *** [4h 6d 4s]
Player23: checks 
Player22: checks 
Player11: bets $0.55
Player23: folds 
Player22: folds 
Uncalled bet ($0.55) returned to Player11
Player11 collected $0.55 from pot
*** SUMMARY ***
Total pot $0.55 | Rake $0 
Board [4h 6d 4s]
Seat 1: Player11 (button) collected ($0.55)
Seat 2: Player14 (small blind) folded before Flop
Seat 3: Player23 (big blind) folded on the Flop
Seat 4: Hero folded before Flop (didn't bet)
Seat 5: Player5 folded before Flop (didn't bet)
Seat 6: Player22 folded on the Flop
Seat 7: Player19 folded before Flop (didn't bet)
Seat 8: Player3 folded before Flop (didn't bet)
Seat 9: Player21 folded before Flop (didn't bet)



PokerStars Game #30758254721:  Hold'em No Limit ($0.01/$0.02 USD) - 2010/05/06 22:52:08 WET [2010/05/06 17:52:08 ET]
Table '99999999' 9-max Seat #2 is the button
Seat 1: Player11 ($1.81 in chips) 
Seat 2: Player14 ($1.18 in chips) 
Seat 3: Player23 ($2.13 in chips) 
Seat 4: Hero ($1.47 in chips) 
Seat 5: Player5 ($2.79 in chips) 
Seat 6: Player22 ($2.56 in chips) 
Seat 7: Player19 ($2.51 in chips) 
Seat 8: Player3 ($3 in chips) 
Seat 9: Player21 ($0.58 in chips) 
Player23: posts small blind $0.01
Hero: posts big blind $0.02
*** HOLE CARDS ***
Dealt to Hero [2c 5d]
Player5: folds 
Player22: folds 
Player19: folds 
Player3: folds 
Player21: folds 
Player11: folds 
Player14: calls $0.02
Player23: calls $0.01
Hero: checks 
*** FLOP *** [8s 4s Ah]
Player23: checks 
Hero: checks 
Player14: bets $0.06
Player23: folds 
Hero: calls $0.06
*** TURN *** [8s 4s Ah] [Qs]
Hero: bets $0.10
Player14: calls $0.10
*** RIVER *** [8s 4s Ah Qs] [9h]
Hero: checks 
Player14: checks 
*** SHOW DOWN ***
Hero: shows [2c 5d] (high card Ace)
Player14: shows [Ac Jc] (a pair of Aces)
Player14 collected $0.38 from pot
*** SUMMARY ***
Total pot $0.38 | Rake $0 
Board [8s 4s Ah Qs 9h]
Seat 1: Player11 folded before Flop (didn't bet)
Seat 2: Player14 (button) showed [Ac Jc] and won ($0.38) with a pair of Aces
Seat 3: Player23 (small blind) folded on the Flop
Seat 4: Hero (big blind) showed [2c 5d] and lost with high card Ace
Seat 5: Player5 folded before Flop (didn't bet)
Seat 6: Player22 folded before Flop (didn't bet)
Seat 7: Player19 folded before Flop (didn't bet)
Seat 8: Player3 folded before Flop (didn't bet)
Seat 9: Player21 folded before Flop (didn't bet)



PokerStars Game #88562623320:  Hold'em No Limit ($0.01/$0.02 USD) - 2010/05/06 22:52:57 WET [2010/05/06 17:52:57 ET]
Table '99999999' 9-max Seat #3 is the button
Seat 1: Player11 ($1.81 in chips) 
Seat 2: Player14 ($1.38 in chips) 
Seat 3: Player23 ($2.11 in chips) 
Seat 4: Hero ($1.29 in chips) 
Seat 5: Player5 ($2.79 in chips) 
Seat 6: Player22 ($2.56 in chips) 
Seat 7: Player19 ($2.51 in chips) 
Seat 8: Player3 ($3 in chips) 
Seat 9: Player21 ($0.58 in chips) 
Hero: posts small blind $0.01
Player5: posts big blind $0.02
*** HOLE CARDS ***
Dealt to Hero [4h Qh]
Player22: folds 
Player19: folds 
Player3: folds 
Player21: folds 
Player11: folds 
Player14: folds 
Player23: raises $0.04 to $0.06
Hero: calls $0.05
Player5: calls $0.04
*** FLOP *** [7s 3s Ah]
Hero: bets $0.20
Player5: folds 
Player23: raises $1.85 to $2.05 and is all-in
Hero: folds 
Uncalled bet ($1.85) returned to Player23
Player23 collected $0.58 from pot
Player23: doesn't show hand 
*** SUMMARY ***
Total pot $0.58 | Rake $0 
Board [7s 3s Ah]
Seat 1: Player11 folded before Flop (didn't bet)
Seat 2: Player14 folded before Flop (didn't bet)
Seat 3: Player23 (button) collected ($0.58)
Seat 4: Hero (small blind) folded on the Flop
Seat 5: Player5 (big blind) folded on the Flop
Seat 6: Player22 folded before Flop (didn't bet)
Seat 7: Player19 folded before Flop (didn't bet)
Seat 8: Player3 folded before Flop (didn't bet)
Seat 9: Player21 folded before Flop (didn't bet)



PokerStars Game #16687242396:  Hold'em No Limit ($0.01/$0.02 USD) - 2010/05/06 22:53:46 WET [2010/05/06 17:53:46 ET]
Table '99999999' 9-max Seat #4 is the button
Seat 1: Player11 ($1.81 in chips) 
Seat 2: Player14 ($1.38 in chips) 
Seat 3: Player23 ($2.43 in chips) 
Seat 4: Hero ($1.03 in chips) 
Seat 5: Player5 ($2.73 in chips) 
Seat 6: Player22 ($2.56 in chips) 
Seat 7: Player19 ($2.51 in chips) 
Seat 8: Player3 ($3 in chips) 
Seat 9: Player21 ($0.58 in chips) 
Player5: posts small blind $0.01
Player22: posts big blind $0.02
*** HOLE CARDS ***
Dealt to Hero [Tc 4s]
Player19: folds 
Player3: folds 
Player21: folds 
Player11: folds 
Player14: folds 
Player23: raises $0.04 to $0.06
Hero: folds 
Player5: folds 
Player22: calls $0.04
*** FLOP *** [2h 7d 3s]
Player22: checks 
Player23: checks 
*** TURN *** [2h 7d 3s] [Ks]
Player22: bets $0.04
Player23: folds 
Uncalled bet ($0.04) returned to Player22
Player22 collected $0.13 from pot
Player22: doesn't show hand 
*** SUMMARY ***
Total pot $0.13 | Rake $0 
Board [2h 7d 3s Ks]
Seat 1: Player11 folded before Flop (didn't bet)
Seat 2: Player14 folded before Flop (didn't bet)
Seat 3: Player23 folded on the Turn
Seat 4: Hero (button) folded before Flop (didn't bet)
Seat 5: Player5 (small blind) folded before Flop
Seat 6: Player22 (big blind) collected ($0.13)
Seat 7: Player19 folded before Flop (didn't bet)
Seat 8: Player3 folded before Flop (didn't bet)
Seat 9: Player21 folded before Flop (didn't bet)



PokerStars Game #20006229758:  Hold'em No Limit ($0.01/$0.02 USD) - 2010/05/06 22:54:17 WET [2010/05/06 17:54:17 ET]
Table '99999999' 9-max Seat #5 is the button
Seat 1: Player11 ($1.81 in chips) 
Seat 2: Player14 ($1.38 in chips) 
Seat 3: Player23 ($2.37 in chips) 
Seat 4: Hero ($1.83 in chips) 
Seat 5: Player5 ($2.72 in chips) 
Seat 6: Player22 ($2.63 in chips) 
Seat 7: Player19 ($2.51 in chips) 
Seat 8: Player3 ($3 in chips) 
Seat 9: Player21 ($0.58 in chips) 
Player22: posts small blind $0.01
Player19: posts big blind $0.02
*** HOLE CARDS ***
Dealt to Hero [Ad 3s]
Player3: folds 
Player21: folds 
Player11: folds 
Player14 has timed out
Player14: folds 
Player23: folds 
Hero: raises $0.06 to $0.08
Player5: folds 
Player22: folds 
Player19: calls $0.06
*** FLOP *** [6d Jd 7c]
Player19: bets $0.04
Hero: calls $0.04
*** TURN *** [6d Jd 7c] [Js]
Player19: checks 
Hero: bets $0.26
Player19: folds 
Uncalled bet ($0.26) returned to Hero
Hero collected $0.25 from pot
Hero: doesn't show hand 
*** SUMMARY ***
Total pot $0.25 | Rake $0 
Board [6d Jd 7c Js]
Seat 1: Player11 folded before Flop (didn't bet)
Seat 2: Player14 folded before Flop (didn't bet)
Seat 3: Player23 folded before Flop (didn't bet)
Seat 4: Hero collected ($0.25)
Seat 5: Player5 (button) folded before Flop (didn't bet)
Seat 6: Player22 (small blind) folded before Flop
Seat 7: Player19 (big blind) folded on the Turn
Seat 8: Player3 folded before Flop (didn't bet)
Seat 9: Player21 folded before Flop (didn't bet)



PokerStars Game #27303244902:  Hold'em No Limit ($0.01/$0.02 USD) - 2010/05/06 22:55:36 WET [2010/05/06 17:55:36 ET]
Table '99999999' 9-max Seat #6 is the button
Seat 1: Player11 ($1.81 in chips) 
Seat 2: Player14 ($1.38 in chips) 
Seat 3: Player23 ($2.37 in chips) 
Seat 4: Hero ($1.96 in chips) 
Seat 5: Player5 ($2.72 in chips) 
Seat 6: Player22 ($2.62 in chips) 
Seat 7: Player19 ($2.39 in chips) 
Seat 8: Player3 ($3 in chips) 
Seat 9: Player21 ($0.58 in chips) 
Player19: posts small blind $0.01
Player3: posts big blind $0.02
*** HOLE CARDS ***
Dealt to Hero [2c 8c]
Player21: raises $0.06 to $0.08
Player11: raises $0.10 to $0.18
Player14: folds 
Player23: folds 
Hero: folds 
Player5: folds 
Player22: folds 
Player19: folds 
Player3: folds 
Player21: raises $0.40 to $0.58 and is all-in
Player11: calls $0.40
*** FLOP *** [Qs Jh 6h]
*** TURN *** [Qs Jh 6h] [Jc]
*** RIVER *** [Qs Jh 6h Jc] [4h]
*** SHOW DOWN ***
Player21: shows [Ah Qh] (a flush, Ace high)
Player11: shows [Ac Qd] (two pair, Queens and Jacks)
Player21 collected $1.14 from pot
*** SUMMARY ***
Total pot $1.19 | Rake $0.05 
Board [Qs Jh 6h Jc 4h]
Seat 1: Player11 showed [Ac Qd] and lost with two pair, Queens and Jacks
Seat 2: Player14 folded before Flop (didn't bet)
Seat 3: Player23 folded before Flop (didn't bet)
Seat 4: Hero folded before Flop (didn't bet)
Seat 5: Player5 folded before Flop (didn't bet)
Seat 6: Player22 (button) folded before Flop (didn't bet)
Seat 7: Player19 (small blind) folded before Flop
Seat 8: Player3 (big blind) folded before Flop
Seat 9: Player21 showed [Ah Qh] and won ($1.14) with a flush, Ace high



PokerStars Game #13363166481:  Hold'em No Limit ($0.01/$0.02 USD) - 2010/05/06 22:56:24 WET [2010/05/06 17:56:24 ET]
Table '99999999' 9-max Seat #7 is the button
Seat 1: Player11 ($1.23 in chips) 
Seat 2: Player14 ($1.38 in chips) 
Seat 3: Player23 ($2.37 in chips) 
Seat 4: Hero ($1.96 in chips) 
Seat 5: Player5 ($2.72 in chips) 
Seat 6: Player22 ($2.62 in chips) 
Seat 7: Player19 ($2.38 in chips) 
Seat 8: Player3 ($3 in chips) 
Seat 9: Player21 ($1.14 in chips) 
Player3: posts small blind $0.01
Player21: posts big blind $0.02
*** HOLE CARDS ***
Dealt to Hero [9c 4h]
Player11: raises $0.04 to $0.06
Player14: folds 
Player23: folds 
Hero: calls $0.06
Player5: calls $0.06
Player22: calls $0.06
Player19: raises $0.18 to $0.24
Player3: folds 
Player21: folds 
Player11: calls $0.18
Hero: calls $0.18
Player5: folds 
Player22: folds 
*** FLOP *** [Th 7c 5s]
Player11: bets $0.23
Hero: folds 
Player19: raises $1.91 to $2.14 and is all-in
Player11: calls $0.76 and is all-in
Uncalled bet ($1.15) returned to Player19
*** TURN *** [Th 7c 5s] [Td]
*** RIVER *** [Th 7c 5s Td] [4s]
*** SHOW DOWN ***
Player11: shows [Kh Qh] (a pair of Tens)
Player19: shows [As Ac] (two pair, Aces and Tens)
Player19 collected $2.75 from pot
*** SUMMARY ***
Total pot $2.85 | Rake $0.10 
Board [Th 7c 5s Td 4s]
Seat 1: Player11 showed [Kh Qh] and lost with a pair of Tens
Seat 2: Player14 folded before Flop (didn't bet)
Seat 3: Player23 folded before Flop (didn't bet)
Seat 4: Hero folded on the Flop
Seat 5: Player5 folded before Flop
Seat 6: Player22 folded before Flop
Seat 7: Player19 (button) showed [As Ac] and won ($2.75) with two pair, Aces and Tens
Seat 8: Player3 (small blind) folded before Flop
Seat 9: Player21 (big blind) folded before Flop



PokerStars Game #27226323531:  Hold'em No Limit ($0.01/$0.02 USD) - 2010/05/06 22:58:18 WET [2010/05/06 17:58:18 ET]
Table '99999999' 9-max Seat #8 is the button
Seat 2: Player14 ($1.38 in chips) 
Seat 3: Player23 ($2.37 in chips) 
Seat 4: Hero ($1.72 in chips) 
Seat 5: Player5 ($2.66 in chips) 
Seat 6: Player22 ($2.56 in chips) 
Seat 7: Player19 ($3.90 in chips) 
Seat 8: Player3 ($3 in chips) 
Seat 9: Player21 ($1.12 in chips) 
Player21: posts small blind $0.01
Player14: posts big blind $0.02
*** HOLE CARDS ***
Dealt to Hero [3d 4d]
Player23: folds 
Hero: calls $0.02
Player11 leaves the table
Player5: folds 
Player22: folds 
Player19: folds 
Player3: calls $0.02
Player21: folds 
Player14: checks 
*** FLOP *** [8s Ad 8h]
Player14: checks 
Hero: checks 
Player3: checks 
*** TURN *** [8s Ad 8h] [8c]
Player14: bets $0.06
Hero: folds 
Player3: folds 
Uncalled bet ($0.06) returned to Player14
Player14 collected $0.07 from pot
*** SUMMARY ***
Total pot $0.07 | Rake $0 
Board [8s Ad 8h 8c]
Seat 2: Player14 (big blind) collected ($0.07)
Seat 3: Player23 folded before Flop (didn't bet)
Seat 4: Hero folded on the Turn
Seat 5: Player5 folded before Flop (didn't bet)
Seat 6: Player22 folded before Flop (didn't bet)
Seat 7: Player19 folded before Flop (didn't bet)
Seat 8: Player3 (button) folded on the Turn
Seat 9: Player21 (small blind) folded before Flop



PokerStars Game #32657659628:  Hold'em No Limit ($0.01/$0.02 USD) - 2010/05/06 22:59:14 WET [2010/05/06 17:59:14 ET]
Table '99999999' 9-max Seat #9 is the button
Seat 2: Player14 ($1.43 in chips) 
Seat 3: Player23 ($2.37 in chips) 
Seat 4: Hero ($1.70 in chips) 
Seat 5: Player5 ($2.66 in chips) 
Seat 6: Player22 ($2.56 in chips) 
Seat 7: Player19 ($3.90 in chips) 
Seat 8: Player3 ($3 in chips) 
Seat 9: Player21 ($1.11 in chips) 
Player14: posts small blind $0.01
Player23: posts big blind $0.02
*** HOLE CARDS ***
Dealt to Hero [Ad Kd]
Hero: calls $0.02
Player5: folds 
Player22: folds 
Player19: folds 
Player3: folds 
Player21: folds 
Player14: calls $0.01
Player23: checks 
*** FLOP *** [5c 9s Kh]
Player14: checks 
Player23: checks 
Hero: checks 
*** TURN *** [5c 9s Kh] [7s]
Player14: bets $0.04
Player23: calls $0.04
Player21 leaves the table
Hero: calls $0.04
*** RIVER *** [5c 9s Kh 7s] [3s]
Player14: bets $0.04
Player23: raises $0.04 to $0.08
Hero: folds 
Player18 joins the table at seat #1 
Player14: calls $0.04
*** SHOW DOWN ***
Player23: shows [Qs Ts] (a flush, Queen high)
Player14: mucks hand 
Player23 collected $0.34 from pot
*** SUMMARY ***
Total pot $0.34 | Rake $0 
Board [5c 9s Kh 7s 3s]
Seat 2: Player14 (small blind) mucked [Kc Td]
Seat 3: Player23 (big blind) showed [Qs Ts] and won ($0.34) with a flush, Queen high
Seat 4: Hero folded on the River
Seat 5: Player5 folded before Flop (didn't bet)
Seat 6: Player22 folded before Flop (didn't bet)
Seat 7: Player19 folded before Flop (didn't bet)
Seat 8: Player3 folded before Flop (didn't bet)
Seat 9: Player21 (button) folded before Flop (didn't bet)



PokerStars Game #22479236161:  Hold'em No Limit ($0.01/$0.02 USD) - 2010/05/06 23:00:15 WET [2010/05/06 18:00:15 ET]
Table '99999999' 9-max Seat #2 is the button
Seat 2: Player14 ($1.29 in chips) 
Seat 3: Player23 ($2.57 in chips) 
Seat 4: Hero ($1.64 in chips) 
Seat 5: Player5 ($2.66 in chips) 
Seat 6: Player22 ($2.56 in chips) 
Seat 7: Player19 ($3.90 in chips) 
Seat 8: Player3 ($3 in chips) 
Player23: posts small blind $0.01
Hero: posts big blind $0.02
Player18: sits out 
*** HOLE CARDS ***
Dealt to Hero [4c Js]
Player5: folds 
Player22: calls $0.02
Player19: folds 
Player3: folds 
Player14: calls $0.02
Player23: calls $0.01
Hero: raises $0.12 to $0.14
Player22: folds 
Player14: folds 
Player23: folds 
Uncalled bet ($0.12) returned to Hero
Hero collected $0.08 from pot
Hero: doesn't show hand 
*** SUMMARY ***
Total pot $0.08 | Rake $0 
Seat 2: Player14 (button) folded before Flop
Seat 3: Player23 (small blind) folded before Flop
Seat 4: Hero (big blind) collected ($0.08)
Seat 5: Player5 folded before Flop (didn't bet)
Seat 6: Player22 folded before Flop
Seat 7: Player19 folded before Flop (didn't bet)
Seat 8: Player3 folded before Flop (didn't bet)



PokerStars Game #12335306021:  Hold'em No Limit ($0.01/$0.02 USD) - 2010/05/06 23:00:44 WET [2010/05/06 18:00:44 ET]
Table '99999999' 9-max Seat #3 is the button
Seat 2: Player14 ($1.27 in chips) 
Seat 3: Player23 ($2.55 in chips) 
Seat 4: Hero ($1.70 in chips) 
Seat 5: Player5 ($2.66 in chips) 
Seat 6: Player22 ($2.54 in chips) 
Seat 7: Player19 ($3.90 in chips) 
Seat 8: Player3 ($3 in chips) 
Hero: posts small blind $0.01
Player5: posts big blind $0.02
Player18: sits out 
*** HOLE CARDS ***
Dealt to Hero [Ts Qc]
Player9 joins the table at seat #9 
Player22: folds 
Player19: folds 
Player3: folds 
Player14: folds 
Player23: folds 
Hero: raises $0.06 to $0.08
Player5: folds 
Uncalled bet ($0.06) returned to Hero
Hero collected $0.04 from pot
Hero: doesn't show hand 
*** SUMMARY ***
Total pot $0.04 | Rake $0 
Seat 2: Player14 folded before Flop (didn't bet)
Seat 3: Player23 (button) folded before Flop (didn't bet)
Seat 4: Hero (small blind) collected ($0.04)
Seat 5: Player5 (big blind) folded before Flop
Seat 6: Player22 folded before Flop (didn't bet)
Seat 7: Player19 folded before Flop (didn't bet)
Seat 8: Player3 folded before Flop (didn't bet)



PokerStars Game #10841092831:  Hold'em No Limit ($0.01/$0.02 USD) - 2010/05/06 23:01:00 WET [2010/05/06 18:01:00 ET]
Table '99999999' 9-max Seat #4 is the button
Seat 2: Player14 ($1.27 in chips) 
Seat 3: Player23 ($2.55 in chips) 
Seat 4: Hero ($1.72 in chips) 
Seat 5: Player5 ($2.64 in chips) 
Seat 6: Player22 ($2.54 in chips) 
Seat 7: Player19 ($3.90 in chips) 
Seat 8: Player3 ($3 in chips) 
Seat 9: Player9 ($1.85 in chips) 
Player5: posts small blind $0.01
Player22: posts big blind $0.02
Player9: posts big blind $0.02
Player18: sits out 
*** HOLE CARDS ***
Dealt to Hero [6d Ac]
Player19: folds 
Player3: folds 
Player9: checks 
Player14: folds 
Player23: folds 
Hero: calls $0.02
Player5: folds 
Player22: checks 
*** FLOP *** [7s 2d 3h]
Player22: checks 
Player9: checks 
Hero: bets $0.04
Player22: calls $0.04
Player9: folds 
*** TURN *** [7s 2d 3h] [5d]
Player22: checks 
Hero: checks 
*** RIVER *** [7s 2d 3h 5d] [7c]
Player22: bets $0.02
Hero: raises $0.06 to $0.08
Player22: raises $0.06 to $0.14
Hero: folds 
Uncalled bet ($0.06) returned to Player22
Player22 collected $0.31 from pot
Player22: doesn't show hand 
*** SUMMARY ***
Total pot $0.31 | Rake $0 
Board [7s 2d 3h 5d 7c]
Seat 2: Player14 folded before Flop (didn't bet)
Seat 3: Player23 folded before Flop (didn't bet)
Seat 4: Hero (button) folded on the River
Seat 5: Player5 (small blind) folded before Flop
Seat 6: Player22 (big blind) collected ($0.31)
Seat 7: Player19 folded before Flop (didn't bet)
Seat 8: Player3 folded before Flop (didn't bet)
Seat 9: Player9 folded on the Flop



PokerStars Game #13957140902:  Hold'em No Limit ($0.01/$0.02 USD) - 2010/05/06 23:02:15 WET [2010/05/06 18:02:15 ET]
Table '99999999' 9-max Seat #5 is the button
Seat 2: Player14 ($1.27 in chips) 
Seat 3: Player23 ($2.55 in chips) 
Seat 4: Hero ($1.58 in chips) 
Seat 5: Player5 ($2.63 in chips) 
Seat 6: Player22 ($2.71 in chips) 
Seat 7: Player19 ($3.90 in chips) 
Seat 8: Player3 ($3 in chips) 
Seat 9: Player9 ($1.83 in chips) 
Player22: posts small blind $0.01
Player19: posts big blind $0.02
Player18: sits out 
*** HOLE CARDS ***
Dealt to Hero [9s Kd]
Player3: folds 
Player9: calls $0.02
Player14: folds 
Player23: folds 
Hero: folds 
Player5: folds 
Player22: calls $0.01
Player19: checks 
*** FLOP *** [9c Qh Tc]
Player22: bets $0.06
Player19: folds 
Player9: calls $0.06
*** TURN *** [9c Qh Tc] [5h]
Player22: bets $0.12
Player9: calls $0.12
*** RIVER *** [9c Qh Tc 5h] [2c]
Player22: bets $0.12
Player9: raises $0.12 to $0.24
Player22: calls $0.12
*** SHOW DOWN ***
Player9: shows [Ac Qc] (a flush, Ace high)
Player22: mucks hand 
Player9 collected $0.90 from pot
*** SUMMARY ***
Total pot $0.90 | Rake $0 
Board [9c Qh Tc 5h 2c]
Seat 2: Player14 folded before Flop (didn't bet)
Seat 3: Player23 folded before Flop (didn't bet)
Seat 4: Hero folded before Flop (didn't bet)
Seat 5: Player5 (button) folded before Flop (didn't bet)
Seat 6: Player22 (small blind) mucked [Js 8c]
Seat 7: Player19 (big blind) folded on the Flop
Seat 8: Player3 folded before Flop (didn't bet)
Seat 9: Player9 showed [Ac Qc] and won ($0.90) with a flush, Ace high



PokerStars Game #91692634264:  Hold'em No Limit ($0.01/$0.02 USD) - 2010/05/06 23:03:25 WET [2010/05/06 18:03:25 ET]
Table '99999999' 9-max Seat #6 is the button
Seat 2: Player14 ($1.27 in chips) 
Seat 3: Player23 ($2.55 in chips) 
Seat 4: Hero ($1.58 in chips) 
Seat 5: Player5 ($2.63 in chips) 
Seat 6: Player22 ($2.27 in chips) 
Seat 7: Player19 ($3.88 in chips) 
Seat 8: Player3 ($3 in chips) 
Seat 9: Player9 ($2.29 in chips) 
Player19: posts small blind $0.01
Player3: posts big blind $0.02
Player18: sits out 
*** HOLE CARDS ***
Dealt to Hero [Ts 9h]
Player9: calls $0.02
Player14: folds 
Player23: folds 
Hero: raises $0.06 to $0.08
Player5: folds 
Player22: calls $0.08
Player19: folds 
Player3: folds 
Player9: calls $0.06
*** FLOP *** [Ad 8s Js]
Player9: checks 
Hero: checks 
Player22: bets $0.08
Player9: folds 
Hero: calls $0.08
*** TURN *** [Ad 8s Js] [3s]
Hero: checks 
Player22: bets $0.08
Hero: calls $0.08
*** RIVER *** [Ad 8s Js 3s] [Jh]
Hero: checks 
Player22: bets $0.25
Hero: folds 
Uncalled bet ($0.25) returned to Player22
Player22 collected $0.59 from pot
Player22: doesn't show hand 
*** SUMMARY ***
Total pot $0.59 | Rake $0 
Board [Ad 8s Js 3s Jh]
Seat 2: Player14 folded before Flop (didn't bet)
Seat 3: Player23 folded before Flop (didn't bet)
Seat 4: Hero folded on the River
Seat 5: Player5 folded before Flop (didn't bet)
Seat 6: Player22 (button) collected ($0.59)
Seat 7: Player19 (small blind) folded before Flop
Seat 8: Player3 (big blind) folded before Flop
Seat 9: Player9 folded on the Flop



PokerStars Game #18556118881:  Hold'em No Limit ($0.01/$0.02 USD) - 2010/05/06 23:04:28 WET [2010/05/06 18:04:28 ET]
Table '99999999' 9-max Seat #7 is the button
Seat 2: Player14 ($1.27 in chips) 
Seat 3: Player23 ($2.55 in chips) 
Seat 4: Hero ($1.34 in chips) 
Seat 5: Player5 ($2.63 in chips) 
Seat 6: Player22 ($2.62 in chips) 
Seat 7: Player19 ($3.87 in chips) 
Seat 8: Player3 ($3 in chips) 
Seat 9: Player9 ($2.21 in chips) 
Player3: posts small blind $0.01
Player9: posts big blind $0.02
Player18: sits out 
*** HOLE CARDS ***
Dealt to Hero [3c Tc]
Player14: folds 
Player23: folds 
Hero: folds 
Player5: folds 
Player22: raises $0.04 to $0.06
Player19: folds 
Player3: folds 
Player9: folds 
Uncalled bet ($0.04) returned to Player22
Player22 collected $0.05 from pot
Player22: doesn't show hand 
*** SUMMARY ***
Total pot $0.05 | Rake $0 
Seat 2: Player14 folded before Flop (didn't bet)
Seat 3: Player23 folded before Flop (didn't bet)
Seat 4: Hero folded before Flop (didn't bet)
Seat 5: Player5 folded before Flop (didn't bet)
Seat 6: Player22 collected ($0.05)
Seat 7: Player19 (button) folded before Flop (didn't bet)
Seat 8: Player3 (small blind) folded before Flop
Seat 9: Player9 (big blind) folded before Flop



PokerStars Game #31790741684:  Hold'em No Limit ($0.01/$0.02 USD) - 2010/05/06 23:04:49 WET [2010/05/06 18:04:49 ET]
Table '99999999' 9-max Seat #8 is the button
Seat 1: Player18 ($0.80 in chips) 
Seat 2: Player14 ($1.27 in chips) 
Seat 3: Player23 ($2.55 in chips) 
Seat 4: Hero ($1.34 in chips) 
Seat 5: Player5 ($2.63 in chips) 
Seat 6: Player22 ($2.65 in chips) 
Seat 7: Player19 ($3.87 in chips) 
Seat 8: Player3 ($3 in chips) 
Seat 9: Player9 ($2.19 in chips) 
Player9: posts small blind $0.01
Player18: posts big blind $0.02
*** HOLE CARDS ***
Dealt to Hero [6c Qs]
Player14: folds 
Player23: folds 
Hero: raises $0.04 to $0.06
Player5: folds 
Player22: folds 
Player19: folds 
Player3: folds 
Player9: folds 
Player18: folds 
Uncalled bet ($0.04) returned to Hero
Hero collected $0.05 from pot
Hero: doesn't show hand 
*** SUMMARY ***
Total pot $0.05 | Rake $0 
Seat 1: Player18 (big blind) folded before Flop
Seat 2: Player14 folded before Flop (didn't bet)
Seat 3: Player23 folded before Flop (didn't bet)
Seat 4: Hero collected ($0.05)
Seat 5: Player5 folded before Flop (didn't bet)
Seat 6: Player22 folded before Flop (didn't bet)
Seat 7: Player19 folded before Flop (didn't bet)
Seat 8: Player3 (button) folded before Flop (didn't bet)
Seat 9: Player9 (small blind) folded before Flop



PokerStars Game #23618143313:  Hold'em No Limit ($0.01/$0.02 USD) - 2010/05/06 23:05:22 WET [2010/05/06 18:05:22 ET]
Table '99999999' 9-max Seat #9 is the button
Seat 1: Player18 ($0.78 in chips) 
Seat 2: Player14 ($1.27 in chips) 
Seat 3: Player23 ($2.55 in chips) 
Seat 4: Hero ($2.17 in chips) 
Seat 5: Player5 ($2.63 in chips) 
Seat 6: Player22 ($2.65 in chips) 
Seat 7: Player19 ($3.87 in chips) 
Seat 8: Player3 ($3 in chips) 
Seat 9: Player9 ($2.18 in chips) 
Player18: posts small blind $0.01
Player14: posts big blind $0.02
*** HOLE CARDS ***
Dealt to Hero [6c Ac]
Player23: folds 
Hero: calls $0.02
Player5: folds 
Player22: calls $0.02
Player19: calls $0.02
Player3: folds 
Player9: calls $0.02
Player18: calls $0.01
Player14: checks 
*** FLOP *** [3s 7s Qh]
Player18: checks 
Player14: checks 
Hero: checks 
Player22: checks 
Player19: checks 
Player9: checks 
*** TURN *** [3s 7s Qh] [Ah]
Player23 leaves the table
Player18: checks 
Player14: checks 
Hero: checks 
Player22: checks 
Player19: checks 
Player9: bets $0.02
Player18: calls $0.02
Player24 joins the table at seat #3 
Player14: calls $0.02
Hero: folds 
Player22: folds 
Player19: folds 
*** RIVER *** [3s 7s Qh Ah] [5d]
Player18: checks 
Player14: checks 
Player9: bets $0.02
Player18: folds 
Player14: folds 
Uncalled bet ($0.02) returned to Player9
Player9 collected $0.18 from pot
*** SUMMARY ***
Total pot $0.18 | Rake $0 
Board [3s 7s Qh Ah 5d]
Seat 1: Player18 (small blind) folded on the River
Seat 2: Player14 (big blind) folded on the River
Seat 3: Player23 folded before Flop (didn't bet)
Seat 4: Hero folded on the Turn
Seat 5: Player5 folded before Flop (didn't bet)
Seat 6: Player22 folded on the Turn
Seat 7: Player19 folded on the Turn
Seat 8: Player3 folded before Flop (didn't bet)
Seat 9: Player9 (button) collected ($0.18)



PokerStars Game #20255202813:  Hold'em No Limit ($0.01/$0.02 USD) - 2010/05/06 23:06:40 WET [2010/05/06 18:06:40 ET]
Table '99999999' 9-max Seat #1 is the button
Seat 1: Player18 ($0.74 in chips) 
Seat 2: Player14 ($1.23 in chips) 
Seat 3: Player24 ($2 in chips) 
Seat 4: Hero ($2.15 in chips) 
Seat 5: Player5 ($2.63 in chips) 
Seat 6: Player22 ($2.63 in chips) 
Seat 7: Player19 ($3.85 in chips) 
Seat 8: Player3 ($3 in chips) 
Seat 9: Player9 ($2.32 in chips) 
Player14: posts small blind $0.01
Player24: posts big blind $0.02
*** HOLE CARDS ***
Dealt to Hero [2c Qc]
Hero: calls $0.02
Player5: folds 
Player22: calls $0.02
Player19: calls $0.02
Player3: calls $0.02
Player9: folds 
Player18: folds 
Player14: calls $0.01
Player24: checks 
*** FLOP *** [5d 2s 3c]
Player14: checks 
Player24: checks 
Hero: bets $0.08
Player22: folds 
Player19: folds 
Player3: folds 
Player14: calls $0.08
Player24: folds 
*** TURN *** [5d 2s 3c] [9d]
Player14: checks 
Hero: bets $0.20
Player14: calls $0.20
*** RIVER *** [5d 2s 3c 9d] [Jc]
Player14: checks 
Hero: checks 
*** SHOW DOWN ***
Player14: shows [4c 4s] (a pair of Fours)
Hero: mucks hand 
Player14 collected $0.68 from pot
*** SUMMARY ***
Total pot $0.68 | Rake $0 
Board [5d 2s 3c 9d Jc]
Seat 1: Player18 (button) folded before Flop (didn't bet)
Seat 2: Player14 (small blind) showed [4c 4s] and won ($0.68) with a pair of Fours
Seat 3: Player24 (big blind) folded on the Flop
Seat 4: Hero mucked [2c Qc]
Seat 5: Player5 folded before Flop (didn't bet)
Seat 6: Player22 folded on the Flop
Seat 7: Player19 folded on the Flop
Seat 8: Player3 folded on the Flop
Seat 9: Player9 folded before Flop (didn't bet)



PokerStars Game #14690416916:  Hold'em No Limit ($0.01/$0.02 USD) - 2010/05/06 23:07:56 WET [2010/05/06 18:07:56 ET]
Table '99999999' 9-max Seat #2 is the button
Seat 1: Player18 ($0.74 in chips) 
Seat 2: Player14 ($1.61 in chips) 
Seat 3: Player24 ($1.98 in chips) 
Seat 4: Hero ($1.85 in chips) 
Seat 5: Player5 ($2.63 in chips) 
Seat 6: Player22 ($2.61 in chips) 
Seat 7: Player19 ($3.83 in chips) 
Seat 8: Player3 ($3 in chips) 
Seat 9: Player9 ($2.32 in chips) 
Player24: posts small blind $0.01
Hero: posts big blind $0.02
*** HOLE CARDS ***
Dealt to Hero [Tc Td]
Player5: folds 
Player22: folds 
Player19: raises $0.06 to $0.08
Player3: folds 
Player9: folds 
Player18: folds 
Player14: folds 
Player24: calls $0.07
Hero: raises $0.40 to $0.48
Player19: raises $3.35 to $3.83 and is all-in
Player24: folds 
Hero: calls $1.37 and is all-in
Uncalled bet ($1.98) returned to Player19
*** FLOP *** [3s 5c 7c]
*** TURN *** [3s 5c 7c] [Th]
*** RIVER *** [3s 5c 7c Th] [Jh]
*** SHOW DOWN ***
Hero: shows [Tc Td] (three of a kind, Tens)
Player19: shows [Ac As] (a pair of Aces)
Hero collected $3.63 from pot
*** SUMMARY ***
Total pot $3.78 | Rake $0.15 
Board [3s 5c 7c Th Jh]
Seat 1: Player18 folded before Flop (didn't bet)
Seat 2: Player14 (button) folded before Flop (didn't bet)
Seat 3: Player24 (small blind) folded before Flop
Seat 4: Hero (big blind) showed [Tc Td] and won ($3.63) with three of a kind, Tens
Seat 5: Player5 folded before Flop (didn't bet)
Seat 6: Player22 folded before Flop (didn't bet)
Seat 7: Player19 showed [Ac As] and lost with a pair of Aces
Seat 8: Player3 folded before Flop (didn't bet)
Seat 9: Player9 folded before Flop (didn't bet)



PokerStars Game #13559160472:  Hold'em No Limit ($0.01/$0.02 USD) - 2010/05/06 23:08:58 WET [2010/05/06 18:08:58 ET]
Table '99999999' 9-max Seat #3 is the button
Seat 1: Player18 ($0.74 in chips) 
Seat 2: Player14 ($1.61 in chips) 
Seat 3: Player24 ($1.90 in chips) 
Seat 4: Hero ($3.63 in chips) 
Seat 5: Player5 ($2.63 in chips) 
Seat 6: Player22 ($2.61 in chips) 
Seat 7: Player19 ($1.98 in chips) 
Seat 8: Player3 ($3 in chips) 
Seat 9: Player9 ($2.32 in chips) 
Hero: posts small blind $0.01
Player5: posts big blind $0.02
*** HOLE CARDS ***
Dealt to Hero [Ad 2s]
Player22: folds 
Player19: folds 
Player3: folds 
Player9: calls $0.02
Player18: folds 
Player14: folds 
Player24: folds 
Hero: calls $0.01
Player5: checks 
*** FLOP *** [6d 7h 3s]
Hero: bets $0.06
Player5: folds 
Player9: calls $0.06
*** TURN *** [6d 7h 3s] [Kc]
Hero: checks 
Player9: bets $0.04
Hero: calls $0.04
*** RIVER *** [6d 7h 3s Kc] [5d]
Hero: checks 
Player9: bets $0.04
Hero: raises $0.22 to $0.26
Player9: calls $0.22
*** SHOW DOWN ***
Hero: shows [Ad 2s] (high card Ace)
Player9: shows [Jc Js] (a pair of Jacks)
Player9 collected $0.78 from pot
*** SUMMARY ***
Total pot $0.78 | Rake $0 
Board [6d 7h 3s Kc 5d]
Seat 1: Player18 folded before Flop (didn't bet)
Seat 2: Player14 folded before Flop (didn't bet)
Seat 3: Player24 (button) folded before Flop (didn't bet)
Seat 4: Hero (small blind) showed [Ad 2s] and lost with high card Ace
Seat 5: Player5 (big blind) folded on the Flop
Seat 6: Player22 folded before Flop (didn't bet)
Seat 7: Player19 folded before Flop (didn't bet)
Seat 8: Player3 folded before Flop (didn't bet)
Seat 9: Player9 showed [Jc Js] and won ($0.78) with a pair of Jacks



PokerStars Game #16011540019:  Hold'em No Limit ($0.01/$0.02 USD) - 2010/05/06 23:10:14 WET [2010/05/06 18:10:14 ET]
Table '99999999' 9-max Seat #4 is the button
Seat 1: Player18 ($0.74 in chips) 
Seat 2: Player14 ($1.61 in chips) 
Seat 3: Player24 ($1.90 in chips) 
Seat 4: Hero ($3.25 in chips) 
Seat 5: Player5 ($2.61 in chips) 
Seat 6: Player22 ($2.61 in chips) 
Seat 7: Player19 ($1.98 in chips) 
Seat 8: Player3 ($3 in chips) 
Seat 9: Player9 ($2.72 in chips) 
Player5: posts small blind $0.01
Player22: posts big blind $0.02
*** HOLE CARDS ***
Dealt to Hero [Ad 3s]
Player19: folds 
Player3: folds 
Player9: calls $0.02
Player18: folds 
Player14: folds 
Player24: folds 
Hero: calls $0.02
Player5: raises $0.10 to $0.12
Player22: folds 
Player9: calls $0.10
Hero: calls $0.10
*** FLOP *** [6h 2c Jd]
Player5: bets $0.29
Player9: folds 
Hero: folds 
Uncalled bet ($0.29) returned to Player5
Player5 collected $0.38 from pot
Player5: doesn't show hand 
*** SUMMARY ***
Total pot $0.38 | Rake $0 
Board [6h 2c Jd]
Seat 1: Player18 folded before Flop (didn't bet)
Seat 2: Player14 folded before Flop (didn't bet)
Seat 3: Player24 folded before Flop (didn't bet)
Seat 4: Hero (button) folded on the Flop
Seat 5: Player5 (small blind) collected ($0.38)
Seat 6: Player22 (big blind) folded before Flop
Seat 7: Player19 folded before Flop (didn't bet)
Seat 8: Player3 folded before Flop (didn't bet)
Seat 9: Player9 folded on the Flop



PokerStars Game #16588282642:  Hold'em No Limit ($0.01/$0.02 USD) - 2010/05/06 23:11:04 WET [2010/05/06 18:11:04 ET]
Table '99999999' 9-max Seat #5 is the button
Seat 1: Player18 ($0.74 in chips) 
Seat 2: Player14 ($1.61 in chips) 
Seat 3: Player24 ($1.90 in chips) 
Seat 4: Hero ($3.13 in chips) 
Seat 5: Player5 ($2.87 in chips) 
Seat 6: Player22 ($2.59 in chips) 
Seat 7: Player19 ($1.98 in chips) 
Seat 8: Player3 ($3 in chips) 
Seat 9: Player9 ($2.60 in chips) 
Player22: posts small blind $0.01
Player19: posts big blind $0.02
*** HOLE CARDS ***
Dealt to Hero [Kd Th]
Player3: folds 
Player9 said, "tu pua madre farolero"
Player9: folds 
Player18: folds 
Player14: folds 
Player24: folds 
Hero: raises $0.06 to $0.08
Player5: folds 
Player22: folds 
Player19: folds 
Uncalled bet ($0.06) returned to Hero
Hero collected $0.05 from pot
Hero: doesn't show hand 
*** SUMMARY ***
Total pot $0.05 | Rake $0 
Seat 1: Player18 folded before Flop (didn't bet)
Seat 2: Player14 folded before Flop (didn't bet)
Seat 3: Player24 folded before Flop (didn't bet)
Seat 4: Hero collected ($0.05)
Seat 5: Player5 (button) folded before Flop (didn't bet)
Seat 6: Player22 (small blind) folded before Flop
Seat 7: Player19 (big blind) folded before Flop
Seat 8: Player3 folded before Flop (didn't bet)
Seat 9: Player9 folded before Flop (didn't bet)



PokerStars Game #22736406243:  Hold'em No Limit ($0.01/$0.02 USD) - 2010/05/06 23:11:29 WET [2010/05/06 18:11:29 ET]
Table '99999999' 9-max Seat #6 is the button
Seat 1: Player18 ($0.74 in chips) 
Seat 2: Player14 ($1.61 in chips) 
Seat 3: Player24 ($1.90 in chips) 
Seat 4: Hero ($3.16 in chips) 
Seat 5: Player5 ($2.87 in chips) 
Seat 6: Player22 ($2.58 in chips) 
Seat 7: Player19 ($1.96 in chips) 
Seat 8: Player3 ($3 in chips) 
Seat 9: Player9 ($2.60 in chips) 
Player19: posts small blind $0.01
Player3: posts big blind $0.02
*** HOLE CARDS ***
Dealt to Hero [Ks 4h]
Player9 has timed out
Player9: folds 
Player18: folds 
Player14: folds 
Player24: folds 
Hero: folds 
Player5: folds 
Player22: raises $0.02 to $0.04
Player19: folds 
Player3: folds 
Uncalled bet ($0.02) returned to Player22
Player22 collected $0.05 from pot
Player22: doesn't show hand 
*** SUMMARY ***
Total pot $0.05 | Rake $0 
Seat 1: Player18 folded before Flop (didn't bet)
Seat 2: Player14 folded before Flop (didn't bet)
Seat 3: Player24 folded before Flop (didn't bet)
Seat 4: Hero folded before Flop (didn't bet)
Seat 5: Player5 folded before Flop (didn't bet)
Seat 6: Player22 (button) collected ($0.05)
Seat 7: Player19 (small blind) folded before Flop
Seat 8: Player3 (big blind) folded before Flop
Seat 9: Player9 folded before Flop (didn't bet)



PokerStars Game #19953154592:  Hold'em No Limit ($0.01/$0.02 USD) - 2010/05/06 23:12:06 WET [2010/05/06 18:12:06 ET]
Table '99999999' 9-max Seat #7 is the button
Seat 1: Player18 ($0.74 in chips) 
Seat 2: Player14 ($1.61 in chips) 
Seat 3: Player24 ($1.90 in chips) 
Seat 4: Hero ($3.16 in chips) 
Seat 5: Player5 ($2.87 in chips) 
Seat 6: Player22 ($2.61 in chips) 
Seat 7: Player19 ($1.95 in chips) 
Seat 8: Player3 ($3 in chips) 
Seat 9: Player9 ($2.60 in chips) 
Player3: posts small blind $0.01
Player9: posts big blind $0.02
*** HOLE CARDS ***
Dealt to Hero [Jd Th]
Player18: folds 
Player14: folds 
Player24: calls $0.02
Hero: calls $0.02
Player5: folds 
Player22: folds 
Player19: folds 
Player3: folds 
Player9: checks 
*** FLOP *** [4d 7d Kh]
Player9: checks 
Player24: checks 
Hero: checks 
*** TURN *** [4d 7d Kh] [3c]
Player9: checks 
Player24: checks 
Hero: bets $0.06
Player9: folds 
Player24: folds 
Uncalled bet ($0.06) returned to Hero
Hero collected $0.07 from pot
Hero: doesn't show hand 
*** SUMMARY ***
Total pot $0.07 | Rake $0 
Board [4d 7d Kh 3c]
Seat 1: Player18 folded before Flop (didn't bet)
Seat 2: Player14 folded before Flop (didn't bet)
Seat 3: Player24 folded on the Turn
Seat 4: Hero collected ($0.07)
Seat 5: Player5 folded before Flop (didn't bet)
Seat 6: Player22 folded before Flop (didn't bet)
Seat 7: Player19 (button) folded before Flop (didn't bet)
Seat 8: Player3 (small blind) folded before Flop
Seat 9: Player9 (big blind) folded on the Turn



PokerStars Game #74551611118:  Hold'em No Limit ($0.01/$0.02 USD) - 2010/05/06 23:13:30 WET [2010/05/06 18:13:30 ET]
Table '99999999' 9-max Seat #8 is the button
Seat 1: Player18 ($0.74 in chips) 
Seat 2: Player14 ($1.61 in chips) 
Seat 3: Player24 ($1.88 in chips) 
Seat 4: Hero ($3.21 in chips) 
Seat 5: Player5 ($2.87 in chips) 
Seat 6: Player22 ($2.61 in chips) 
Seat 7: Player19 ($1.95 in chips) 
Seat 8: Player3 ($3 in chips) 
Seat 9: Player9 ($2.58 in chips) 
Player9: posts small blind $0.01
Player18: posts big blind $0.02
*** HOLE CARDS ***
Dealt to Hero [9s 3d]
Player14: folds 
Player24: folds 
Hero: folds 
Player5: folds 
Player22: folds 
Player19: folds 
Player3: folds 
Player9: calls $0.01
Player18: checks 
*** FLOP *** [3c Ac Kc]
Player9: bets $0.02
Player18: calls $0.02
*** TURN *** [3c Ac Kc] [Qc]
Player9: bets $0.04
Player18: folds 
Uncalled bet ($0.04) returned to Player9
Player9 collected $0.08 from pot
*** SUMMARY ***
Total pot $0.08 | Rake $0 
Board [3c Ac Kc Qc]
Seat 1: Player18 (big blind) folded on the Turn
Seat 2: Player14 folded before Flop (didn't bet)
Seat 3: Player24 folded before Flop (didn't bet)
Seat 4: Hero folded before Flop (didn't bet)
Seat 5: Player5 folded before Flop (didn't bet)
Seat 6: Player22 folded before Flop (didn't bet)
Seat 7: Player19 folded before Flop (didn't bet)
Seat 8: Player3 (button) folded before Flop (didn't bet)
Seat 9: Player9 (small blind) collected ($0.08)



PokerStars Game #64594322241:  Hold'em No Limit ($0.01/$0.02 USD) - 2010/05/06 23:14:39 WET [2010/05/06 18:14:39 ET]
Table '99999999' 9-max Seat #9 is the button
Seat 1: Player18 ($0.70 in chips) 
Seat 2: Player14 ($1.61 in chips) 
Seat 3: Player24 ($1.88 in chips) 
Seat 4: Hero ($3.21 in chips) 
Seat 5: Player5 ($2.87 in chips) 
Seat 6: Player22 ($2.61 in chips) 
Seat 7: Player19 ($1.95 in chips) 
Seat 8: Player3 ($3 in chips) 
Seat 9: Player9 ($2.62 in chips) 
Player18: posts small blind $0.01
Player14: posts big blind $0.02
*** HOLE CARDS ***
Dealt to Hero [6h 5c]
Player24: folds 
Hero: calls $0.02
Player5: folds 
Player22: calls $0.02
Player19: folds 
Player3: folds 
Player9: calls $0.02
Player18: folds 
Player14: checks 
*** FLOP *** [4c 7c 6s]
Player14: checks 
Hero: bets $0.08
Player22: folds 
Player9: calls $0.08
Player14: folds 
*** TURN *** [4c 7c 6s] [Th]
Hero: bets $0.32
Player9: folds 
Uncalled bet ($0.32) returned to Hero
Hero collected $0.25 from pot
Hero: doesn't show hand 
*** SUMMARY ***
Total pot $0.25 | Rake $0 
Board [4c 7c 6s Th]
Seat 1: Player18 (small blind) folded before Flop
Seat 2: Player14 (big blind) folded on the Flop
Seat 3: Player24 folded before Flop (didn't bet)
Seat 4: Hero collected ($0.25)
Seat 5: Player5 folded before Flop (didn't bet)
Seat 6: Player22 folded on the Flop
Seat 7: Player19 folded before Flop (didn't bet)
Seat 8: Player3 folded before Flop (didn't bet)
Seat 9: Player9 (button) folded on the Turn



PokerStars Game #20220303142:  Hold'em No Limit ($0.01/$0.02 USD) - 2010/05/06 23:16:08 WET [2010/05/06 18:16:08 ET]
Table '99999999' 9-max Seat #1 is the button
Seat 1: Player18 ($0.69 in chips) 
Seat 2: Player14 ($1.59 in chips) 
Seat 3: Player24 ($1.88 in chips) 
Seat 4: Hero ($3.36 in chips) 
Seat 5: Player5 ($2.87 in chips) 
Seat 6: Player22 ($2.59 in chips) 
Seat 7: Player19 ($1.95 in chips) 
Seat 8: Player3 ($3 in chips) 
Seat 9: Player9 ($2.52 in chips) 
Player14: posts small blind $0.01
Player24: posts big blind $0.02
*** HOLE CARDS ***
Dealt to Hero [7c Tc]
Hero: calls $0.02
Player5: raises $0.10 to $0.12
Player22: calls $0.12
Player19: folds 
Player3: folds 
Player9: folds 
Player18: folds 
Player14: folds 
Player24: folds 
Hero: calls $0.10
*** FLOP *** [Jh 6c 5d]
Hero: checks 
Player5: bets $0.29
Player22: folds 
Hero: calls $0.29
*** TURN *** [Jh 6c 5d] [9d]
Hero: bets $0.32
Player5: folds 
Uncalled bet ($0.32) returned to Hero
Hero collected $0.97 from pot
Hero: doesn't show hand 
*** SUMMARY ***
Total pot $0.97 | Rake $0 
Board [Jh 6c 5d 9d]
Seat 1: Player18 (button) folded before Flop (didn't bet)
Seat 2: Player14 (small blind) folded before Flop
Seat 3: Player24 (big blind) folded before Flop
Seat 4: Hero collected ($0.97)
Seat 5: Player5 folded on the Turn
Seat 6: Player22 folded on the Flop
Seat 7: Player19 folded before Flop (didn't bet)
Seat 8: Player3 folded before Flop (didn't bet)
Seat 9: Player9 folded before Flop (didn't bet)



PokerStars Game #15797308302:  Hold'em No Limit ($0.01/$0.02 USD) - 2010/05/06 23:17:04 WET [2010/05/06 18:17:04 ET]
Table '99999999' 9-max Seat #2 is the button
Seat 1: Player18 ($0.69 in chips) 
Seat 2: Player14 ($1.58 in chips) 
Seat 3: Player24 ($1.86 in chips) 
Seat 4: Hero ($3.92 in chips) 
Seat 5: Player5 ($2.46 in chips) 
Seat 6: Player22 ($2.47 in chips) 
Seat 7: Player19 ($1.95 in chips) 
Seat 8: Player3 ($3 in chips) 
Seat 9: Player9 ($2.52 in chips) 
Player24: posts small blind $0.01
Hero: posts big blind $0.02
*** HOLE CARDS ***
Dealt to Hero [9c 3s]
Player5: folds 
Player22: folds 
Player19: folds 
Player3: folds 
Player9: calls $0.02
Player18: folds 
Player14: folds 
Player24: calls $0.01
Hero: checks 
*** FLOP *** [2s Jd Qd]
Player24: checks 
Hero: folds 
Player9: checks 
*** TURN *** [2s Jd Qd] [7h]
Player24: bets $0.06
Player9: folds 
Uncalled bet ($0.06) returned to Player24
Player24 collected $0.06 from pot
*** SUMMARY ***
Total pot $0.06 | Rake $0 
Board [2s Jd Qd 7h]
Seat 1: Player18 folded before Flop (didn't bet)
Seat 2: Player14 (button) folded before Flop (didn't bet)
Seat 3: Player24 (small blind) collected ($0.06)
Seat 4: Hero (big blind) folded on the Flop
Seat 5: Player5 folded before Flop (didn't bet)
Seat 6: Player22 folded before Flop (didn't bet)
Seat 7: Player19 folded before Flop (didn't bet)
Seat 8: Player3 folded before Flop (didn't bet)
Seat 9: Player9 folded on the Turn



PokerStars Game #22202259791:  Hold'em No Limit ($0.01/$0.02 USD) - 2010/05/06 23:18:12 WET [2010/05/06 18:18:12 ET]
Table '99999999' 9-max Seat #3 is the button
Seat 1: Player18 ($0.69 in chips) 
Seat 2: Player14 ($1.58 in chips) 
Seat 3: Player24 ($1.90 in chips) 
Seat 4: Hero ($3.90 in chips) 
Seat 5: Player5 ($2.46 in chips) 
Seat 6: Player22 ($2.47 in chips) 
Seat 7: Player19 ($1.95 in chips) 
Seat 8: Player3 ($3 in chips) 
Seat 9: Player9 ($2.50 in chips) 
Hero: posts small blind $0.01
Player5: posts big blind $0.02
*** HOLE CARDS ***
Dealt to Hero [As 3c]
Player22: calls $0.02
Player19: folds 
Player3: folds 
Player9: calls $0.02
Player18: folds 
Player14: folds 
Player24: folds 
Hero: folds 
Player5: checks 
*** FLOP *** [6s Js 9d]
Player5: checks 
Player22: bets $0.04
Player9: folds 
Player5: folds 
Uncalled bet ($0.04) returned to Player22
Player22 collected $0.07 from pot
Player22: doesn't show hand 
*** SUMMARY ***
Total pot $0.07 | Rake $0 
Board [6s Js 9d]
Seat 1: Player18 folded before Flop (didn't bet)
Seat 2: Player14 folded before Flop (didn't bet)
Seat 3: Player24 (button) folded before Flop (didn't bet)
Seat 4: Hero (small blind) folded before Flop
Seat 5: Player5 (big blind) folded on the Flop
Seat 6: Player22 collected ($0.07)
Seat 7: Player19 folded before Flop (didn't bet)
Seat 8: Player3 folded before Flop (didn't bet)
Seat 9: Player9 folded on the Flop



PokerStars Game #23635931413:  Hold'em No Limit ($0.01/$0.02 USD) - 2010/05/06 23:19:45 WET [2010/05/06 18:19:45 ET]
Table '99999999' 9-max Seat #4 is the button
Seat 1: Player18 ($0.69 in chips) 
Seat 2: Player14 ($1.58 in chips) 
Seat 3: Player24 ($1.90 in chips) 
Seat 4: Hero ($3.89 in chips) 
Seat 5: Player5 ($2.44 in chips) 
Seat 6: Player22 ($2.52 in chips) 
Seat 7: Player19 ($1.95 in chips) 
Seat 8: Player3 ($3 in chips) 
Seat 9: Player9 ($2.48 in chips) 
Player5: posts small blind $0.01
Player22: posts big blind $0.02
*** HOLE CARDS ***
Dealt to Hero [8d 6h]
Player19: raises $0.04 to $0.06
Player3: folds 
Player9: folds 
Player18: folds 
Player14: folds 
Player24: folds 
Hero: calls $0.06
Player5: folds 
Player22: folds 
*** FLOP *** [5c 4h 3h]
Player19: bets $0.08
Hero: calls $0.08
*** TURN *** [5c 4h 3h] [5s]
Player19: bets $0.10
Hero: calls $0.10
*** RIVER *** [5c 4h 3h 5s] [9s]
Player19: bets $0.14
Hero: folds 
Uncalled bet ($0.14) returned to Player19
Player19 collected $0.51 from pot
Player19: doesn't show hand 
*** SUMMARY ***
Total pot $0.51 | Rake $0 
Board [5c 4h 3h 5s 9s]
Seat 1: Player18 folded before Flop (didn't bet)
Seat 2: Player14 folded before Flop (didn't bet)
Seat 3: Player24 folded before Flop (didn't bet)
Seat 4: Hero (button) folded on the River
Seat 5: Player5 (small blind) folded before Flop
Seat 6: Player22 (big blind) folded before Flop
Seat 7: Player19 collected ($0.51)
Seat 8: Player3 folded before Flop (didn't bet)
Seat 9: Player9 folded before Flop (didn't bet)



PokerStars Game #16301246877:  Hold'em No Limit ($0.01/$0.02 USD) - 2010/05/06 23:20:42 WET [2010/05/06 18:20:42 ET]
Table '99999999' 9-max Seat #5 is the button
Seat 1: Player18 ($0.69 in chips) 
Seat 2: Player14 ($1.58 in chips) 
Seat 3: Player24 ($1.90 in chips) 
Seat 4: Hero ($3.65 in chips) 
Seat 5: Player5 ($2.43 in chips) 
Seat 6: Player22 ($2.50 in chips) 
Seat 7: Player19 ($2.22 in chips) 
Seat 8: Player3 ($3 in chips) 
Seat 9: Player9 ($2.48 in chips) 
Player22: posts small blind $0.01
Player19: posts big blind $0.02
*** HOLE CARDS ***
Dealt to Hero [2s 4c]
Player3: folds 
Player9: calls $0.02
Player18: folds 
Player14: folds 
Player24: calls $0.02
Hero: calls $0.02
Player5: folds 
Player22: folds 
Player19: checks 
*** FLOP *** [Jh 9h Ac]
Player19: checks 
Player9: checks 
Player24: checks 
Hero: checks 
*** TURN *** [Jh 9h Ac] [2d]
Player19: checks 
Player9: bets $0.02
Player24: calls $0.02
Hero: calls $0.02
Player19: folds 
*** RIVER *** [Jh 9h Ac 2d] [Kd]
Player9: bets $0.02
Player24: calls $0.02
Hero: folds 
*** SHOW DOWN ***
Player9: shows [Qc Qd] (a pair of Queens)
Player24: shows [7d Ad] (a pair of Aces)
Player24 collected $0.19 from pot
*** SUMMARY ***
Total pot $0.19 | Rake $0 
Board [Jh 9h Ac 2d Kd]
Seat 1: Player18 folded before Flop (didn't bet)
Seat 2: Player14 folded before Flop (didn't bet)
Seat 3: Player24 showed [7d Ad] and won ($0.19) with a pair of Aces
Seat 4: Hero folded on the River
Seat 5: Player5 (button) folded before Flop (didn't bet)
Seat 6: Player22 (small blind) folded before Flop
Seat 7: Player19 (big blind) folded on the Turn
Seat 8: Player3 folded before Flop (didn't bet)
Seat 9: Player9 showed [Qc Qd] and lost with a pair of Queens



PokerStars Game #21693130641:  Hold'em No Limit ($0.01/$0.02 USD) - 2010/05/06 23:22:02 WET [2010/05/06 18:22:02 ET]
Table '99999999' 9-max Seat #6 is the button
Seat 1: Player18 ($0.69 in chips) 
Seat 2: Player14 ($1.58 in chips) 
Seat 3: Player24 ($2.03 in chips) 
Seat 4: Hero ($3.61 in chips) 
Seat 5: Player5 ($2.43 in chips) 
Seat 6: Player22 ($2.49 in chips) 
Seat 7: Player19 ($2.20 in chips) 
Seat 8: Player3 ($3 in chips) 
Seat 9: Player9 ($2.42 in chips) 
Player19: posts small blind $0.01
Player3: posts big blind $0.02
*** HOLE CARDS ***
Dealt to Hero [Kd 9d]
Player9: calls $0.02
Player18: folds 
Player14: folds 
Player24: folds 
Hero: raises $0.04 to $0.06
Player5: calls $0.06
Player22: folds 
Player19: folds 
Player3: folds 
Player9: calls $0.04
*** FLOP *** [Tc Ts 8s]
Player9: checks 
Hero: checks 
Player5: checks 
*** TURN *** [Tc Ts 8s] [Jh]
Player9: checks 
Hero: bets $0.12
Player5: folds 
Player9: folds 
Uncalled bet ($0.12) returned to Hero
Hero collected $0.21 from pot
Hero: doesn't show hand 
*** SUMMARY ***
Total pot $0.21 | Rake $0 
Board [Tc Ts 8s Jh]
Seat 1: Player18 folded before Flop (didn't bet)
Seat 2: Player14 folded before Flop (didn't bet)
Seat 3: Player24 folded before Flop (didn't bet)
Seat 4: Hero collected ($0.21)
Seat 5: Player5 folded on the Turn
Seat 6: Player22 (button) folded before Flop (didn't bet)
Seat 7: Player19 (small blind) folded before Flop
Seat 8: Player3 (big blind) folded before Flop
Seat 9: Player9 folded on the Turn



PokerStars Game #80731798515:  Hold'em No Limit ($0.01/$0.02 USD) - 2010/05/06 23:23:16 WET [2010/05/06 18:23:16 ET]
Table '99999999' 9-max Seat #7 is the button
Seat 1: Player18 ($0.69 in chips) 
Seat 2: Player14 ($1.58 in chips) 
Seat 3: Player24 ($2.03 in chips) 
Seat 4: Hero ($3.76 in chips) 
Seat 5: Player5 ($2.37 in chips) 
Seat 6: Player22 ($2.49 in chips) 
Seat 7: Player19 ($2.19 in chips) 
Seat 8: Player3 ($3 in chips) 
Seat 9: Player9 ($2.36 in chips) 
Player3: posts small blind $0.01
Player9: posts big blind $0.02
*** HOLE CARDS ***
Dealt to Hero [Ah Ad]
Player18: folds 
Player14: folds 
Player24: folds 
Hero: raises $0.06 to $0.08
Player5: folds 
Player5 leaves the table
Player22: folds 
Player19: folds 
Player3: folds 
Player9: folds 
Uncalled bet ($0.06) returned to Hero
Hero collected $0.05 from pot
Hero: doesn't show hand 
*** SUMMARY ***
Total pot $0.05 | Rake $0 
Seat 1: Player18 folded before Flop (didn't bet)
Seat 2: Player14 folded before Flop (didn't bet)
Seat 3: Player24 folded before Flop (didn't bet)
Seat 4: Hero collected ($0.05)
Seat 5: Player5 folded before Flop (didn't bet)
Seat 6: Player22 folded before Flop (didn't bet)
Seat 7: Player19 (button) folded before Flop (didn't bet)
Seat 8: Player3 (small blind) folded before Flop
Seat 9: Player9 (big blind) folded before Flop



PokerStars Game #12041521491:  Hold'em No Limit ($0.01/$0.02 USD) - 2010/05/06 23:23:53 WET [2010/05/06 18:23:53 ET]
Table '99999999' 9-max Seat #8 is the button
Seat 1: Player18 ($0.69 in chips) 
Seat 2: Player14 ($1.58 in chips) 
Seat 3: Player24 ($2.03 in chips) 
Seat 4: Hero ($3.79 in chips) 
Seat 6: Player22 ($2.49 in chips) 
Seat 7: Player19 ($2.19 in chips) 
Seat 8: Player3 ($3 in chips) 
Seat 9: Player9 ($2.34 in chips) 
Player9: posts small blind $0.01
Player18: posts big blind $0.02
*** HOLE CARDS ***
Dealt to Hero [8h 8s]
Player14: folds 
Player24: folds 
Hero: calls $0.02
Player22: folds 
Player19: folds 
Player3: calls $0.02
Player9: calls $0.01
Player18: checks 
*** FLOP *** [Ts 5c 5h]
Player0 joins the table at seat #5 
Player9: checks 
Player18: checks 
Hero: checks 
Player3: checks 
*** TURN *** [Ts 5c 5h] [9h]
Player9: checks 
Player18: checks 
Hero: checks 
Player3: checks 
*** RIVER *** [Ts 5c 5h 9h] [2d]
Player9: checks 
Player18: checks 
Hero: checks 
Player3: checks 
*** SHOW DOWN ***
Player9: shows [8d Qh] (a pair of Fives)
Player18: mucks hand 
Hero: shows [8h 8s] (two pair, Eights and Fives)
Player3: mucks hand 
Hero collected $0.08 from pot
*** SUMMARY ***
Total pot $0.08 | Rake $0 
Board [Ts 5c 5h 9h 2d]
Seat 1: Player18 (big blind) mucked [Js 3h]
Seat 2: Player14 folded before Flop (didn't bet)
Seat 3: Player24 folded before Flop (didn't bet)
Seat 4: Hero showed [8h 8s] and won ($0.08) with two pair, Eights and Fives
Seat 6: Player22 folded before Flop (didn't bet)
Seat 7: Player19 folded before Flop (didn't bet)
Seat 8: Player3 (button) mucked [Ac 3c]
Seat 9: Player9 (small blind) showed [8d Qh] and lost with a pair of Fives



PokerStars Game #32267943121:  Hold'em No Limit ($0.01/$0.02 USD) - 2010/05/06 23:25:21 WET [2010/05/06 18:25:21 ET]
Table '99999999' 9-max Seat #9 is the button
Seat 1: Player18 ($0.67 in chips) 
Seat 2: Player14 ($1.58 in chips) 
Seat 3: Player24 ($2.03 in chips) 
Seat 4: Hero ($3.85 in chips) 
Seat 5: Player0 ($1.60 in chips) 
Seat 6: Player22 ($2.49 in chips) 
Seat 7: Player19 ($2.19 in chips) 
Seat 8: Player3 ($3 in chips) 
Seat 9: Player9 ($2.32 in chips) 
Player18: posts small blind $0.01
Player14: posts big blind $0.02
Player0: posts big blind $0.02
*** HOLE CARDS ***
Dealt to Hero [9h Kc]
Player24: folds 
Hero: folds 
Player0: raises $0.04 to $0.06
Player22: calls $0.06
Player19: folds 
Player3: folds 
Player9: calls $0.06
Player18: folds 
Player14: calls $0.04
*** FLOP *** [As 4s Js]
Player14: checks 
Player0: checks 
Player22: checks 
Player9: bets $0.10
Player14: folds 
Player0: folds 
Player22: calls $0.10
*** TURN *** [As 4s Js] [4c]
Player22: checks 
Player9: bets $0.16
Player22: calls $0.16
*** RIVER *** [As 4s Js 4c] [Jc]
Player22: checks 
Player9: bets $0.16
Player22: raises $0.36 to $0.52
Player9: calls $0.36
*** SHOW DOWN ***
Player22: shows [Ks Qd] (two pair, Jacks and Fours)
Player9: shows [Ad 8h] (two pair, Aces and Jacks)
Player9 collected $1.76 from pot
*** SUMMARY ***
Total pot $1.81 | Rake $0.05 
Board [As 4s Js 4c Jc]
Seat 1: Player18 (small blind) folded before Flop
Seat 2: Player14 (big blind) folded on the Flop
Seat 3: Player24 folded before Flop (didn't bet)
Seat 4: Hero folded before Flop (didn't bet)
Seat 5: Player0 folded on the Flop
Seat 6: Player22 showed [Ks Qd] and lost with two pair, Jacks and Fours
Seat 7: Player19 folded before Flop (didn't bet)
Seat 8: Player3 folded before Flop (didn't bet)
Seat 9: Player9 (button) showed [Ad 8h] and won ($1.76) with two pair, Aces and Jacks



PokerStars Game #21796253433:  Hold'em No Limit ($0.01/$0.02 USD) - 2010/05/06 23:27:01 WET [2010/05/06 18:27:01 ET]
Table '99999999' 9-max Seat #1 is the button
Seat 1: Player18 ($0.66 in chips) 
Seat 2: Player14 ($1.52 in chips) 
Seat 3: Player24 ($2.03 in chips) 
Seat 4: Hero ($3.85 in chips) 
Seat 5: Player0 ($1.54 in chips) 
Seat 6: Player22 ($1.65 in chips) 
Seat 7: Player19 ($2.19 in chips) 
Seat 8: Player3 ($3 in chips) 
Seat 9: Player9 ($3.24 in chips) 
Player14: posts small blind $0.01
Player24: posts big blind $0.02
*** HOLE CARDS ***
Dealt to Hero [6h 8d]
Hero: folds 
Player0: raises $0.02 to $0.04
Player22: raises $0.04 to $0.08
Player19: calls $0.08
Player3: folds 
Player9: calls $0.08
Player18: folds 
Player14: folds 
Player24: folds 
Player0: calls $0.04
*** FLOP *** [4d Td 4s]
Player0: bets $0.22
Player22: folds 
Player19: folds 
Player9: folds 
Uncalled bet ($0.22) returned to Player0
Player0 collected $0.35 from pot
Player0: doesn't show hand 
*** SUMMARY ***
Total pot $0.35 | Rake $0 
Board [4d Td 4s]
Seat 1: Player18 (button) folded before Flop (didn't bet)
Seat 2: Player14 (small blind) folded before Flop
Seat 3: Player24 (big blind) folded before Flop
Seat 4: Hero folded before Flop (didn't bet)
Seat 5: Player0 collected ($0.35)
Seat 6: Player22 folded on the Flop
Seat 7: Player19 folded on the Flop
Seat 8: Player3 folded before Flop (didn't bet)
Seat 9: Player9 folded on the Flop



PokerStars Game #20106934129:  Hold'em No Limit ($0.01/$0.02 USD) - 2010/05/06 23:27:44 WET [2010/05/06 18:27:44 ET]
Table '99999999' 9-max Seat #2 is the button
Seat 1: Player18 ($0.66 in chips) 
Seat 2: Player14 ($1.51 in chips) 
Seat 3: Player24 ($2.01 in chips) 
Seat 4: Hero ($3.85 in chips) 
Seat 5: Player0 ($1.81 in chips) 
Seat 6: Player22 ($1.57 in chips) 
Seat 7: Player19 ($2.11 in chips) 
Seat 8: Player3 ($3 in chips) 
Seat 9: Player9 ($3.16 in chips) 
Player24: posts small blind $0.01
Hero: posts big blind $0.02
*** HOLE CARDS ***
Dealt to Hero [8d Jd]
Player0: folds 
Player22: calls $0.02
Player19: folds 
Player3: calls $0.02
Player9: calls $0.02
Player18: folds 
Player14: folds 
Player24: calls $0.01
Hero: raises $0.02 to $0.04
Player22: calls $0.02
Player3: calls $0.02
Player9: calls $0.02
Player24: calls $0.02
*** FLOP *** [6d 9s 3d]
Player24: checks 
Hero: bets $0.02
Player22: folds 
Player3: folds 
Player9: calls $0.02
Player24: calls $0.02
*** TURN *** [6d 9s 3d] [3c]
Player24: checks 
Hero: bets $0.02
Player9: calls $0.02
Player24: folds 
*** RIVER *** [6d 9s 3d 3c] [5c]
Hero: bets $0.02
Player9: calls $0.02
*** SHOW DOWN ***
Hero: shows [8d Jd] (a pair of Threes)
Player9: shows [Ts 6s] (two pair, Sixes and Threes)
Player9 collected $0.34 from pot
*** SUMMARY ***
Total pot $0.34 | Rake $0 
Board [6d 9s 3d 3c 5c]
Seat 1: Player18 folded before Flop (didn't bet)
Seat 2: Player14 (button) folded before Flop (didn't bet)
Seat 3: Player24 (small blind) folded on the Turn
Seat 4: Hero (big blind) showed [8d Jd] and lost with a pair of Threes
Seat 5: Player0 folded before Flop (didn't bet)
Seat 6: Player22 folded on the Flop
Seat 7: Player19 folded before Flop (didn't bet)
Seat 8: Player3 folded on the Flop
Seat 9: Player9 showed [Ts 6s] and won ($0.34) with two pair, Sixes and Threes



PokerStars Game #69512225343:  Hold'em No Limit ($0.01/$0.02 USD) - 2010/05/06 23:28:40 WET [2010/05/06 18:28:40 ET]
Table '99999999' 9-max Seat #3 is the button
Seat 1: Player18 ($0.66 in chips) 
Seat 2: Player14 ($1.51 in chips) 
Seat 3: Player24 ($1.95 in chips) 
Seat 4: Hero ($3.75 in chips) 
Seat 5: Player0 ($1.81 in chips) 
Seat 6: Player22 ($1.53 in chips) 
Seat 7: Player19 ($2.11 in chips) 
Seat 8: Player3 ($3 in chips) 
Seat 9: Player9 ($3.40 in chips) 
Hero: posts small blind $0.01
Player0: posts big blind $0.02
*** HOLE CARDS ***
Dealt to Hero [5c As]
Player22: folds 
Player19: folds 
Player3: folds 
Player9: calls $0.02
Player18: folds 
Player14: calls $0.02
Player24: folds 
Hero: calls $0.01
Player0: checks 
*** FLOP *** [3s 2c 5s]
Hero: checks 
Player0: bets $0.04
Player9: calls $0.04
Player14: folds 
Hero: raises $0.22 to $0.26
Player0: raises $0.22 to $0.48
Player9: folds 
Hero: calls $0.22
*** TURN *** [3s 2c 5s] [2h]
Hero: bets $0.36
Player0: calls $0.36
*** RIVER *** [3s 2c 5s 2h] [3d]
Hero: bets $0.90
Player0: raises $0.05 to $0.95 and is all-in
Hero: calls $0.05
*** SHOW DOWN ***
Player0: shows [5d 3h] (a full house, Threes full of Fives)
Hero: shows [5c As] (two pair, Fives and Threes)
Player0 collected $3.55 from pot
*** SUMMARY ***
Total pot $3.70 | Rake $0.15 
Board [3s 2c 5s 2h 3d]
Seat 1: Player18 folded before Flop (didn't bet)
Seat 2: Player14 folded on the Flop
Seat 3: Player24 (button) folded before Flop (didn't bet)
Seat 4: Hero (small blind) showed [5c As] and lost with two pair, Fives and Threes
Seat 5: Player0 (big blind) showed [5d 3h] and won ($3.55) with a full house, Threes full of Fives
Seat 6: Player22 folded before Flop (didn't bet)
Seat 7: Player19 folded before Flop (didn't bet)
Seat 8: Player3 folded before Flop (didn't bet)
Seat 9: Player9 folded on the Flop



PokerStars Game #69681723765:  Hold'em No Limit ($0.01/$0.02 USD) - 2010/05/06 23:30:11 WET [2010/05/06 18:30:11 ET]
Table '99999999' 9-max Seat #4 is the button
Seat 1: Player18 ($0.66 in chips) 
Seat 2: Player14 ($1.49 in chips) 
Seat 3: Player24 ($1.95 in chips) 
Seat 4: Hero ($1.94 in chips) 
Seat 5: Player0 ($3.55 in chips) 
Seat 6: Player22 ($1.53 in chips) 
Seat 7: Player19 ($2.11 in chips) 
Seat 8: Player3 ($3 in chips) 
Seat 9: Player9 ($3.34 in chips) 
Player0: posts small blind $0.01
Player22: posts big blind $0.02
*** HOLE CARDS ***
Dealt to Hero [Kc 9d]
Player19: folds 
Player3: folds 
Player9: calls $0.02
Player18: folds 
Player14: folds 
Player24: folds 
Hero: folds 
Player0: calls $0.01
Player22: checks 
*** FLOP *** [6h 2s Ad]
Player9 said, "jajajaja tonto"
Player0: checks 
Player22: bets $0.02
Player9: calls $0.02
Player0: calls $0.02
*** TURN *** [6h 2s Ad] [9s]
Player0: checks 
Player22: checks 
Player9: checks 
*** RIVER *** [6h 2s Ad 9s] [Jh]
Player0: checks 
Player22: bets $0.06
Player9: calls $0.06
Player0: folds 
*** SHOW DOWN ***
Player22: shows [As 5d] (a pair of Aces)
Player9: mucks hand 
Player22 collected $0.24 from pot
*** SUMMARY ***
Total pot $0.24 | Rake $0 
Board [6h 2s Ad 9s Jh]
Seat 1: Player18 folded before Flop (didn't bet)
Seat 2: Player14 folded before Flop (didn't bet)
Seat 3: Player24 folded before Flop (didn't bet)
Seat 4: Hero (button) folded before Flop (didn't bet)
Seat 5: Player0 (small blind) folded on the River
Seat 6: Player22 (big blind) showed [As 5d] and won ($0.24) with a pair of Aces
Seat 7: Player19 folded before Flop (didn't bet)
Seat 8: Player3 folded before Flop (didn't bet)
Seat 9: Player9 mucked [Ts Qs]



PokerStars Game #30142164314:  Hold'em No Limit ($0.01/$0.02 USD) - 2010/05/06 23:31:00 WET [2010/05/06 18:31:00 ET]
Table '99999999' 9-max Seat #5 is the button
Seat 1: Player18 ($0.66 in chips) 
Seat 2: Player14 ($1.49 in chips) 
Seat 3: Player24 ($1.95 in chips) 
Seat 4: Hero ($3.54 in chips) 
Seat 5: Player0 ($3.51 in chips) 
Seat 6: Player22 ($1.67 in chips) 
Seat 7: Player19 ($2.11 in chips) 
Seat 8: Player3 ($3 in chips) 
Seat 9: Player9 ($3.24 in chips) 
Player22: posts small blind $0.01
Player19: posts big blind $0.02
*** HOLE CARDS ***
Dealt to Hero [5d 6c]
Player3: folds 
Player9: calls $0.02
Player18: folds 
Player14: folds 
Player24: folds 
Hero: calls $0.02
Player0: calls $0.02
Player22: calls $0.01
Player19: checks 
*** FLOP *** [Jh 7d 8h]
Player22: checks 
Player19: checks 
Player9: checks 
Hero: bets $0.06
Player0: calls $0.06
Player22: folds 
Player19: folds 
Player9: calls $0.06
*** TURN *** [Jh 7d 8h] [Qc]
Player9: checks 
Hero: checks 
Player0: checks 
*** RIVER *** [Jh 7d 8h Qc] [5c]
Player9: bets $0.04
Hero: folds 
Player0: calls $0.04
*** SHOW DOWN ***
Player9: shows [Ah Kh] (high card Ace)
Player0: shows [As 8s] (a pair of Eights)
Player0 collected $0.36 from pot
*** SUMMARY ***
Total pot $0.36 | Rake $0 
Board [Jh 7d 8h Qc 5c]
Seat 1: Player18 folded before Flop (didn't bet)
Seat 2: Player14 folded before Flop (didn't bet)
Seat 3: Player24 folded before Flop (didn't bet)
Seat 4: Hero folded on the River
Seat 5: Player0 (button) showed [As 8s] and won ($0.36) with a pair of Eights
Seat 6: Player22 (small blind) folded on the Flop
Seat 7: Player19 (big blind) folded on the Flop
Seat 8: Player3 folded before Flop (didn't bet)
Seat 9: Player9 showed [Ah Kh] and lost with high card Ace



PokerStars Game #10018305383:  Hold'em No Limit ($0.01/$0.02 USD) - 2010/05/06 23:31:54 WET [2010/05/06 18:31:54 ET]
Table '99999999' 9-max Seat #6 is the button
Seat 1: Player18 ($0.66 in chips) 
Seat 2: Player14 ($1.49 in chips) 
Seat 3: Player24 ($1.95 in chips) 
Seat 4: Hero ($3.46 in chips) 
Seat 5: Player0 ($3.75 in chips) 
Seat 6: Player22 ($1.65 in chips) 
Seat 7: Player19 ($2.09 in chips) 
Seat 8: Player3 ($3 in chips) 
Seat 9: Player9 ($3.12 in chips) 
Player19: posts small blind $0.01
Player3: posts big blind $0.02
*** HOLE CARDS ***
Dealt to Hero [Kh 2h]
Player9: folds 
Player18: folds 
Player14: folds 
Player24: calls $0.02
Hero: calls $0.02
Player0: raises $0.04 to $0.06
Player22: folds 
Player19: folds 
Player3: folds 
Player24: calls $0.04
Hero: calls $0.04
*** FLOP *** [2s 2d Kc]
Player24: checks 
Hero: bets $0.06
Player0: calls $0.06
Player24: folds 
*** TURN *** [2s 2d Kc] [7h]
Hero: bets $0.20
Player0: calls $0.20
*** RIVER *** [2s 2d Kc 7h] [5s]
Hero: bets $3.04
Player0 said, "lol"
Player0 said, "such bs"
Player0: folds 
Uncalled bet ($3.04) returned to Hero
Hero collected $0.73 from pot
Hero: doesn't show hand 
*** SUMMARY ***
Total pot $0.73 | Rake $0 
Board [2s 2d Kc 7h 5s]
Seat 1: Player18 folded before Flop (didn't bet)
Seat 2: Player14 folded before Flop (didn't bet)
Seat 3: Player24 folded on the Flop
Seat 4: Hero collected ($0.73)
Seat 5: Player0 folded on the River
Seat 6: Player22 (button) folded before Flop (didn't bet)
Seat 7: Player19 (small blind) folded before Flop
Seat 8: Player3 (big blind) folded before Flop
Seat 9: Player9 folded before Flop (didn't bet)



PokerStars Game #45323247626:  Hold'em No Limit ($0.01/$0.02 USD) - 2010/05/06 23:33:01 WET [2010/05/06 18:33:01 ET]
Table '99999999' 9-max Seat #7 is the button
Seat 1: Player18 ($0.66 in chips) 
Seat 2: Player14 ($1.49 in chips) 
Seat 3: Player24 ($1.89 in chips) 
Seat 4: Hero ($3.87 in chips) 
Seat 5: Player0 ($3.43 in chips) 
Seat 6: Player22 ($1.65 in chips) 
Seat 7: Player19 ($2.08 in chips) 
Seat 8: Player3 ($3 in chips) 
Seat 9: Player9 ($3.12 in chips) 
Player3: posts small blind $0.01
Player9: posts big blind $0.02
*** HOLE CARDS ***
Dealt to Hero [2c Ad]
Player18: folds 
Player14: folds 
Player24: folds 
Hero: folds 
Player0: folds 
Player22: folds 
Player19: calls $0.02
Player3: folds 
Player9: checks 
*** FLOP *** [2h Kd 8d]
Player9: bets $0.02
Player19: folds 
Uncalled bet ($0.02) returned to Player9
Player9 collected $0.05 from pot
Player0 leaves the table
*** SUMMARY ***
Total pot $0.05 | Rake $0 
Board [2h Kd 8d]
Seat 1: Player18 folded before Flop (didn't bet)
Seat 2: Player14 folded before Flop (didn't bet)
Seat 3: Player24 folded before Flop (didn't bet)
Seat 4: Hero folded before Flop (didn't bet)
Seat 5: Player0 folded before Flop (didn't bet)
Seat 6: Player22 folded before Flop (didn't bet)
Seat 7: Player19 (button) folded on the Flop
Seat 8: Player3 (small blind) folded before Flop
Seat 9: Player9 (big blind) collected ($0.05)



PokerStars Game #56232290155:  Hold'em No Limit ($0.01/$0.02 USD) - 2010/05/06 23:33:27 WET [2010/05/06 18:33:27 ET]
Table '99999999' 9-max Seat #8 is the button
Seat 1: Player18 ($0.66 in chips) 
Seat 2: Player14 ($1.49 in chips) 
Seat 3: Player24 ($1.89 in chips) 
Seat 4: Hero ($3.87 in chips) 
Seat 6: Player22 ($1.65 in chips) 
Seat 7: Player19 ($2.06 in chips) 
Seat 8: Player3 ($3 in chips) 
Seat 9: Player9 ($3.15 in chips) 
Player9: posts small blind $0.01
Player18: posts big blind $0.02
*** HOLE CARDS ***
Dealt to Hero [4h Ah]
Player14: folds 
Player24: folds 
Hero: raises $0.04 to $0.06
Player22: calls $0.06
Player19: calls $0.06
Player3: folds 
Player9: folds 
Player18: folds 
*** FLOP *** [Qs 5c Qc]
Hero: checks 
Player22: bets $0.09
Player19: folds 
Hero: folds 
Uncalled bet ($0.09) returned to Player22
Player22 collected $0.21 from pot
Player22: doesn't show hand 
*** SUMMARY ***
Total pot $0.21 | Rake $0 
Board [Qs 5c Qc]
Seat 1: Player18 (big blind) folded before Flop
Seat 2: Player14 folded before Flop (didn't bet)
Seat 3: Player24 folded before Flop (didn't bet)
Seat 4: Hero folded on the Flop
Seat 6: Player22 collected ($0.21)
Seat 7: Player19 folded on the Flop
Seat 8: Player3 (button) folded before Flop (didn't bet)
Seat 9: Player9 (small blind) folded before Flop



PokerStars Game #32171206783:  Hold'em No Limit ($0.01/$0.02 USD) - 2010/05/06 23:34:30 WET [2010/05/06 18:34:30 ET]
Table '99999999' 9-max Seat #9 is the button
Seat 1: Player18 ($0.64 in chips) 
Seat 2: Player14 ($1.49 in chips) 
Seat 3: Player24 ($1.89 in chips) 
Seat 4: Hero ($3.81 in chips) 
Seat 6: Player22 ($1.80 in chips) 
Seat 7: Player19 ($2 in chips) 
Seat 8: Player3 ($3 in chips) 
Seat 9: Player9 ($3.14 in chips) 
Player18: posts small blind $0.01
Player14: posts big blind $0.02
*** HOLE CARDS ***
Dealt to Hero [Kd 6c]
Player24: folds 
Hero: raises $0.06 to $0.08
Player22: folds 
Player19: calls $0.08
Player3: folds 
Player9: calls $0.08
Player18: folds 
Player14: folds 
*** FLOP *** [8s 3d 7h]
Hero: bets $0.18
Player15 joins the table at seat #5 
Player19: raises $0.18 to $0.36
Player9: folds 
Hero: folds 
Uncalled bet ($0.18) returned to Player19
Player19 collected $0.63 from pot
Player19: doesn't show hand 
*** SUMMARY ***
Total pot $0.63 | Rake $0 
Board [8s 3d 7h]
Seat 1: Player18 (small blind) folded before Flop
Seat 2: Player14 (big blind) folded before Flop
Seat 3: Player24 folded before Flop (didn't bet)
Seat 4: Hero folded on the Flop
Seat 6: Player22 folded before Flop (didn't bet)
Seat 7: Player19 collected ($0.63)
Seat 8: Player3 folded before Flop (didn't bet)
Seat 9: Player9 (button) folded on the Flop



PokerStars Game #58591999729:  Hold'em No Limit ($0.01/$0.02 USD) - 2010/05/06 23:35:54 WET [2010/05/06 18:35:54 ET]
Table '99999999' 9-max Seat #1 is the button
Seat 1: Player18 ($0.63 in chips) 
Seat 2: Player14 ($1.47 in chips) 
Seat 3: Player24 ($1.89 in chips) 
Seat 4: Hero ($3.55 in chips) 
Seat 6: Player22 ($1.80 in chips) 
Seat 7: Player19 ($2.37 in chips) 
Seat 8: Player3 ($3 in chips) 
Seat 9: Player9 ($3.06 in chips) 
Player14: posts small blind $0.01
Player24: posts big blind $0.02
Player15: sits out 
*** HOLE CARDS ***
Dealt to Hero [5d Ks]
Hero: folds 
Player22: folds 
Player19: calls $0.02
Player3: folds 
Player9: calls $0.02
Player18: folds 
Player14: folds 
Player24: checks 
*** FLOP *** [3h Kh 2c]
Player24: checks 
Player19: bets $0.02
Player9 said, "maumont paga botes que tonto eres"
Player9: calls $0.02
Player18 leaves the table
Player24: folds 
*** TURN *** [3h Kh 2c] [Jd]
Player19: checks 
Player9: bets $0.04
Player19: folds 
Uncalled bet ($0.04) returned to Player9
Player9 collected $0.11 from pot
*** SUMMARY ***
Total pot $0.11 | Rake $0 
Board [3h Kh 2c Jd]
Seat 1: Player18 (button) folded before Flop (didn't bet)
Seat 2: Player14 (small blind) folded before Flop
Seat 3: Player24 (big blind) folded on the Flop
Seat 4: Hero folded before Flop (didn't bet)
Seat 6: Player22 folded before Flop (didn't bet)
Seat 7: Player19 folded on the Turn
Seat 8: Player3 folded before Flop (didn't bet)
Seat 9: Player9 collected ($0.11)



PokerStars Game #19663159832:  Hold'em No Limit ($0.01/$0.02 USD) - 2010/05/06 23:37:19 WET [2010/05/06 18:37:19 ET]
Table '99999999' 9-max Seat #2 is the button
Seat 2: Player14 ($1.46 in chips) 
Seat 3: Player24 ($1.87 in chips) 
Seat 4: Hero ($3.55 in chips) 
Seat 6: Player22 ($1.80 in chips) 
Seat 7: Player19 ($2.33 in chips) 
Seat 8: Player3 ($3 in chips) 
Seat 9: Player9 ($3.13 in chips) 
Player24: posts small blind $0.01
Hero: posts big blind $0.02
Player15: sits out 
*** HOLE CARDS ***
Dealt to Hero [8s 2h]
Player22: folds 
Player19: folds 
Player3: folds 
Player9: folds 
Player14: calls $0.02
Player24: calls $0.01
Hero: raises $0.12 to $0.14
Player14: calls $0.12
Player24: folds 
*** FLOP *** [3h As 7h]
Hero: checks 
Player14: bets $0.20
Hero: folds 
Uncalled bet ($0.20) returned to Player14
Player14 collected $0.30 from pot
*** SUMMARY ***
Total pot $0.30 | Rake $0 
Board [3h As 7h]
Seat 2: Player14 (button) collected ($0.30)
Seat 3: Player24 (small blind) folded before Flop
Seat 4: Hero (big blind) folded on the Flop
Seat 6: Player22 folded before Flop (didn't bet)
Seat 7: Player19 folded before Flop (didn't bet)
Seat 8: Player3 folded before Flop (didn't bet)
Seat 9: Player9 folded before Flop (didn't bet)



PokerStars Game #32364377323:  Hold'em No Limit ($0.01/$0.02 USD) - 2010/05/06 23:38:08 WET [2010/05/06 18:38:08 ET]
Table '99999999' 9-max Seat #3 is the button
Seat 2: Player14 ($1.62 in chips) 
Seat 3: Player24 ($1.85 in chips) 
Seat 4: Hero ($3.41 in chips) 
Seat 5: Player15 ($1 in chips) 
Seat 6: Player22 ($1.80 in chips) 
Seat 7: Player19 ($2.33 in chips) 
Seat 8: Player3 ($3 in chips) 
Seat 9: Player9 ($3.13 in chips) 
Hero: posts small blind $0.01
Player15: posts big blind $0.02
*** HOLE CARDS ***
Dealt to Hero [Ad Qh]
Player22: calls $0.02
Player19: folds 
Player3: folds 
Player9: folds 
Player14: folds 
Player24: folds 
Hero: raises $0.92 to $0.94
Player15: folds 
Player22: folds 
Uncalled bet ($0.92) returned to Hero
Hero collected $0.06 from pot
Hero: doesn't show hand 
*** SUMMARY ***
Total pot $0.06 | Rake $0 
Seat 2: Player14 folded before Flop (didn't bet)
Seat 3: Player24 (button) folded before Flop (didn't bet)
Seat 4: Hero (small blind) collected ($0.06)
Seat 5: Player15 (big blind) folded before Flop
Seat 6: Player22 folded before Flop
Seat 7: Player19 folded before Flop (didn't bet)
Seat 8: Player3 folded before Flop (didn't bet)
Seat 9: Player9 folded before Flop (didn't bet)



PokerStars Game #23073312602:  Hold'em No Limit ($0.01/$0.02 USD) - 2010/05/06 23:38:35 WET [2010/05/06 18:38:35 ET]
Table '99999999' 9-max Seat #4 is the button
Seat 2: Player14 ($1.62 in chips) 
Seat 3: Player24 ($1.85 in chips) 
Seat 4: Hero ($3.45 in chips) 
Seat 5: Player15 ($0.98 in chips) 
Seat 6: Player22 ($1.78 in chips) 
Seat 7: Player19 ($2.33 in chips) 
Seat 8: Player3 ($3 in chips) 
Seat 9: Player9 ($3.13 in chips) 
Player15: posts small blind $0.01
Player22: posts big blind $0.02
*** HOLE CARDS ***
Dealt to Hero [3h Qh]
Player19: folds 
Player3: folds 
Player9: calls $0.02
Player14: folds 
Player24: calls $0.02
Hero: raises $0.04 to $0.06
Player15: folds 
Player22: folds 
Player9: calls $0.04
Player24: calls $0.04
*** FLOP *** [3c 4s 7h]
Player9: checks 
Player24: checks 
Hero: checks 
*** TURN *** [3c 4s 7h] [3s]
Player9: checks 
Player24: checks 
Hero: bets $0.14
Player9: folds 
Player24: folds 
Uncalled bet ($0.14) returned to Hero
Hero collected $0.21 from pot
Hero: doesn't show hand 
*** SUMMARY ***
Total pot $0.21 | Rake $0 
Board [3c 4s 7h 3s]
Seat 2: Player14 folded before Flop (didn't bet)
Seat 3: Player24 folded on the Turn
Seat 4: Hero (button) collected ($0.21)
Seat 5: Player15 (small blind) folded before Flop
Seat 6: Player22 (big blind) folded before Flop
Seat 7: Player19 folded before Flop (didn't bet)
Seat 8: Player3 folded before Flop (didn't bet)
Seat 9: Player9 folded on the Turn



PokerStars Game #89372402099:  Hold'em No Limit ($0.01/$0.02 USD) - 2010/05/06 23:40:14 WET [2010/05/06 18:40:14 ET]
Table '99999999' 9-max Seat #5 is the button
Seat 2: Player14 ($1.62 in chips) 
Seat 3: Player24 ($1.79 in chips) 
Seat 4: Hero ($3.60 in chips) 
Seat 5: Player15 ($0.97 in chips) 
Seat 6: Player22 ($1.76 in chips) 
Seat 7: Player19 ($2.33 in chips) 
Seat 8: Player3 ($3 in chips) 
Seat 9: Player9 ($3.07 in chips) 
Player22: posts small blind $0.01
Player19: posts big blind $0.02
*** HOLE CARDS ***
Dealt to Hero [Td 8d]
Player3: folds 
Player9: calls $0.02
Player14: folds 
Player24: calls $0.02
Hero: raises $0.16 to $0.18
Player15: folds 
Player22: folds 
Player19: folds 
Player9: calls $0.16
Player24: calls $0.16
*** FLOP *** [2d 9s Ts]
Player9: checks 
Player24: checks 
Hero: bets $0.42
Player9: folds 
Player24: folds 
Uncalled bet ($0.42) returned to Hero
Hero collected $0.57 from pot
Hero: doesn't show hand 
*** SUMMARY ***
Total pot $0.57 | Rake $0 
Board [2d 9s Ts]
Seat 2: Player14 folded before Flop (didn't bet)
Seat 3: Player24 folded on the Flop
Seat 4: Hero collected ($0.57)
Seat 5: Player15 (button) folded before Flop (didn't bet)
Seat 6: Player22 (small blind) folded before Flop
Seat 7: Player19 (big blind) folded before Flop
Seat 8: Player3 folded before Flop (didn't bet)
Seat 9: Player9 folded on the Flop



PokerStars Game #27215384828:  Hold'em No Limit ($0.01/$0.02 USD) - 2010/05/06 23:41:23 WET [2010/05/06 18:41:23 ET]
Table '99999999' 9-max Seat #6 is the button
Seat 2: Player14 ($1.62 in chips) 
Seat 3: Player24 ($1.61 in chips) 
Seat 4: Hero ($3.99 in chips) 
Seat 5: Player15 ($0.97 in chips) 
Seat 6: Player22 ($1.75 in chips) 
Seat 7: Player19 ($2.31 in chips) 
Seat 8: Player3 ($3 in chips) 
Seat 9: Player9 ($2.89 in chips) 
Player19: posts small blind $0.01
Player3: posts big blind $0.02
*** HOLE CARDS ***
Dealt to Hero [5s 7d]
Player20 joins the table at seat #1 
Player9: calls $0.02
Player14: folds 
Player24: folds 
Hero: folds 
Player15: folds 
Player15 leaves the table
Player22: calls $0.02
Player19: raises $0.04 to $0.06
Player3: folds 
Player9: calls $0.04
Player22: calls $0.04
*** FLOP *** [8d Jh 7c]
Player19: bets $0.10
Player12 joins the table at seat #5 
Player9: calls $0.10
Player22: calls $0.10
*** TURN *** [8d Jh 7c] [5c]
Player19: bets $0.30
Player9: calls $0.30
Player22: folds 
*** RIVER *** [8d Jh 7c 5c] [Qc]
Player19: bets $0.22
Player9: raises $2.21 to $2.43 and is all-in
Player19 has timed out
Player19: folds 
Uncalled bet ($2.21) returned to Player9
Player9 collected $1.49 from pot
*** SUMMARY ***
Total pot $1.54 | Rake $0.05 
Board [8d Jh 7c 5c Qc]
Seat 2: Player14 folded before Flop (didn't bet)
Seat 3: Player24 folded before Flop (didn't bet)
Seat 4: Hero folded before Flop (didn't bet)
Seat 5: Player15 folded before Flop (didn't bet)
Seat 6: Player22 (button) folded on the Turn
Seat 7: Player19 (small blind) folded on the River
Seat 8: Player3 (big blind) folded before Flop
Seat 9: Player9 collected ($1.49)



PokerStars Game #32706209671:  Hold'em No Limit ($0.01/$0.02 USD) - 2010/05/06 23:43:15 WET [2010/05/06 18:43:15 ET]
Table '99999999' 9-max Seat #7 is the button
Seat 2: Player14 ($1.62 in chips) 
Seat 3: Player24 ($1.61 in chips) 
Seat 4: Hero ($3.99 in chips) 
Seat 5: Player12 ($1 in chips) 
Seat 6: Player22 ($1.59 in chips) 
Seat 7: Player19 ($1.63 in chips) 
Seat 8: Player3 ($3 in chips) 
Seat 9: Player9 ($3.70 in chips) 
Player3: posts small blind $0.01
Player9: posts big blind $0.02
Player20: sits out 
Player12: posts big blind $0.02
*** HOLE CARDS ***
Dealt to Hero [9c 2c]
Player14: folds 
Player24: folds 
Hero: raises $0.04 to $0.06
Player12: folds 
Player22: folds 
Player19: folds 
Player3: folds 
Player9: folds 
Uncalled bet ($0.04) returned to Hero
Hero collected $0.07 from pot
Hero: doesn't show hand 
*** SUMMARY ***
Total pot $0.07 | Rake $0 
Seat 2: Player14 folded before Flop (didn't bet)
Seat 3: Player24 folded before Flop (didn't bet)
Seat 4: Hero collected ($0.07)
Seat 5: Player12 folded before Flop
Seat 6: Player22 folded before Flop (didn't bet)
Seat 7: Player19 (button) folded before Flop (didn't bet)
Seat 8: Player3 (small blind) folded before Flop
Seat 9: Player9 (big blind) folded before Flop



PokerStars Game #99425634223:  Hold'em No Limit ($0.01/$0.02 USD) - 2010/05/06 23:43:32 WET [2010/05/06 18:43:32 ET]
Table '99999999' 9-max Seat #8 is the button
Seat 1: Player20 ($5 in chips) 
Seat 2: Player14 ($1.62 in chips) 
Seat 3: Player24 ($1.61 in chips) 
Seat 4: Hero ($4.04 in chips) 
Seat 5: Player12 ($0.98 in chips) 
Seat 6: Player22 ($1.59 in chips) 
Seat 7: Player19 ($1.63 in chips) 
Seat 8: Player3 ($3 in chips) 
Seat 9: Player9 ($3.68 in chips) 
Player9: posts small blind $0.01
Player20: posts big blind $0.02
*** HOLE CARDS ***
Dealt to Hero [9d Tc]
Player14: folds 
Player24: folds 
Player14 leaves the table
Hero: folds 
Player12: folds 
Player22: calls $0.02
Player19: folds 
Player3: folds 
Player9: calls $0.01
Player20: checks 
*** FLOP *** [7d 4h Qs]
Player9: checks 
Player20: checks 
Player22: checks 
*** TURN *** [7d 4h Qs] [3c]
Player9: bets $0.02
Player20: calls $0.02
Player22: calls $0.02
*** RIVER *** [7d 4h Qs 3c] [Kd]
Player9: bets $0.04
Player20: folds 
Player22: raises $0.05 to $0.09
Player9: calls $0.05
*** SHOW DOWN ***
Player22: shows [Ts Kh] (a pair of Kings)
Player9: mucks hand 
Player22 collected $0.30 from pot
*** SUMMARY ***
Total pot $0.30 | Rake $0 
Board [7d 4h Qs 3c Kd]
Seat 1: Player20 (big blind) folded on the River
Seat 2: Player14 folded before Flop (didn't bet)
Seat 3: Player24 folded before Flop (didn't bet)
Seat 4: Hero folded before Flop (didn't bet)
Seat 5: Player12 folded before Flop (didn't bet)
Seat 6: Player22 showed [Ts Kh] and won ($0.30) with a pair of Kings
Seat 7: Player19 folded before Flop (didn't bet)
Seat 8: Player3 (button) folded before Flop (didn't bet)
Seat 9: Player9 (small blind) mucked [Jh Qd]



PokerStars Game #23826224249:  Hold'em No Limit ($0.01/$0.02 USD) - 2010/05/06 23:44:18 WET [2010/05/06 18:44:18 ET]
Table '99999999' 9-max Seat #9 is the button
Seat 1: Player20 ($4.96 in chips) 
Seat 3: Player24 ($1.61 in chips) 
Seat 4: Hero ($4.04 in chips) 
Seat 5: Player12 ($0.98 in chips) 
Seat 6: Player22 ($1.76 in chips) 
Seat 7: Player19 ($1.63 in chips) 
Seat 8: Player3 ($3 in chips) 
Seat 9: Player9 ($3.55 in chips) 
Player20: posts small blind $0.01
Player24: posts big blind $0.02
*** HOLE CARDS ***
Dealt to Hero [2h 7h]
Hero: raises $0.04 to $0.06
Player12: calls $0.06
Player22: calls $0.06
Player19: folds 
Player3: folds 
Player9: calls $0.06
Player2 joins the table at seat #2 
Player20: folds 
Player24: calls $0.04
*** FLOP *** [2d 4s 5d]
Player24: checks 
Hero: checks 
Player12: checks 
Player22: bets $0.06
Player9: calls $0.06
Player24: folds 
Hero: calls $0.06
Player12: folds 
*** TURN *** [2d 4s 5d] [Kc]
Hero: checks 
Player22: checks 
Player9: checks 
*** RIVER *** [2d 4s 5d Kc] [Ks]
Hero: checks 
Player22: checks 
Player9: bets $0.40
Hero: folds 
Player22: folds 
Uncalled bet ($0.40) returned to Player9
Player9 collected $0.49 from pot
*** SUMMARY ***
Total pot $0.49 | Rake $0 
Board [2d 4s 5d Kc Ks]
Seat 1: Player20 (small blind) folded before Flop
Seat 3: Player24 (big blind) folded on the Flop
Seat 4: Hero folded on the River
Seat 5: Player12 folded on the Flop
Seat 6: Player22 folded on the River
Seat 7: Player19 folded before Flop (didn't bet)
Seat 8: Player3 folded before Flop (didn't bet)
Seat 9: Player9 (button) collected ($0.49)



PokerStars Game #28582235522:  Hold'em No Limit ($0.01/$0.02 USD) - 2010/05/06 23:45:42 WET [2010/05/06 18:45:42 ET]
Table '99999999' 9-max Seat #1 is the button
Seat 1: Player20 ($4.95 in chips) 
Seat 3: Player24 ($1.55 in chips) 
Seat 4: Hero ($3.92 in chips) 
Seat 5: Player12 ($0.92 in chips) 
Seat 6: Player22 ($1.64 in chips) 
Seat 7: Player19 ($1.63 in chips) 
Seat 8: Player3 ($3 in chips) 
Seat 9: Player9 ($3.92 in chips) 
Player2 will be allowed to play after the button
Player24: posts small blind $0.01
Hero: posts big blind $0.02
*** HOLE CARDS ***
Dealt to Hero [8h Qd]
Player12: calls $0.02
Player22: folds 
Player19: folds 
Player19 leaves the table
Player3: folds 
Player9: calls $0.02
Player20: raises $0.10 to $0.12
Player24: folds 
Hero: folds 
Player12: calls $0.10
Player9: folds 
*** FLOP *** [3h Js Td]
Player12: checks 
Player20: bets $0.20
Player12: folds 
Uncalled bet ($0.20) returned to Player20
Player20 collected $0.29 from pot
Player20: doesn't show hand 
*** SUMMARY ***
Total pot $0.29 | Rake $0 
Board [3h Js Td]
Seat 1: Player20 (button) collected ($0.29)
Seat 3: Player24 (small blind) folded before Flop
Seat 4: Hero (big blind) folded before Flop
Seat 5: Player12 folded on the Flop
Seat 6: Player22 folded before Flop (didn't bet)
Seat 7: Player19 folded before Flop (didn't bet)
Seat 8: Player3 folded before Flop (didn't bet)
Seat 9: Player9 folded before Flop



PokerStars Game #11849119171:  Hold'em No Limit ($0.01/$0.02 USD) - 2010/05/06 23:46:22 WET [2010/05/06 18:46:22 ET]
Table '99999999' 9-max Seat #3 is the button
Seat 1: Player20 ($5.12 in chips) 
Seat 2: Player2 ($1 in chips) 
Seat 3: Player24 ($1.54 in chips) 
Seat 4: Hero ($3.90 in chips) 
Seat 5: Player12 ($0.80 in chips) 
Seat 6: Player22 ($1.64 in chips) 
Seat 8: Player3 ($3 in chips) 
Seat 9: Player9 ($3.90 in chips) 
Hero: posts small blind $0.01
Player12: posts big blind $0.02
Player2: posts big blind $0.02
*** HOLE CARDS ***
Dealt to Hero [Jh Ah]
Player22: folds 
Player3: folds 
Player9: calls $0.02
Player20: folds 
Player2: checks 
Player8 joins the table at seat #7 
Player24: calls $0.02
Hero: raises $0.08 to $0.10
Player12: folds 
Player9: folds 
Player2: folds 
Player24: folds 
Uncalled bet ($0.08) returned to Hero
Hero collected $0.10 from pot
Hero: doesn't show hand 
*** SUMMARY ***
Total pot $0.10 | Rake $0 
Seat 1: Player20 folded before Flop (didn't bet)
Seat 2: Player2 folded before Flop
Seat 3: Player24 (button) folded before Flop
Seat 4: Hero (small blind) collected ($0.10)
Seat 5: Player12 (big blind) folded before Flop
Seat 6: Player22 folded before Flop (didn't bet)
Seat 8: Player3 folded before Flop (didn't bet)
Seat 9: Player9 folded before Flop



PokerStars Game #71932031318:  Hold'em No Limit ($0.01/$0.02 USD) - 2010/05/06 23:46:53 WET [2010/05/06 18:46:53 ET]
Table '99999999' 9-max Seat #4 is the button
Seat 1: Player20 ($5.12 in chips) 
Seat 2: Player2 ($0.98 in chips) 
Seat 3: Player24 ($1.52 in chips) 
Seat 4: Hero ($3.98 in chips) 
Seat 5: Player12 ($0.78 in chips) 
Seat 6: Player22 ($1.64 in chips) 
Seat 7: Player8 ($1.11 in chips) 
Seat 8: Player3 ($3 in chips) 
Seat 9: Player9 ($3.88 in chips) 
Player12: posts small blind $0.01
Player22: posts big blind $0.02
Player8: posts big blind $0.02
*** HOLE CARDS ***
Dealt to Hero [Jc 2h]
Player8: checks 
Player3: folds 
Player9: calls $0.02
Player20: calls $0.02
Player2: folds 
Player24: folds 
Hero: folds 
Player12: calls $0.01
Player22: checks 
*** FLOP *** [Jh Tc 2d]
Player12: checks 
Player22: bets $0.02
Player8: calls $0.02
Player9: folds 
Player20: calls $0.02
Player12: calls $0.02
*** TURN *** [Jh Tc 2d] [Js]
Player12: checks 
Player22: bets $0.08
Player8: folds 
Player20: folds 
Player12: folds 
Uncalled bet ($0.08) returned to Player22
Player22 collected $0.18 from pot
*** SUMMARY ***
Total pot $0.18 | Rake $0 
Board [Jh Tc 2d Js]
Seat 1: Player20 folded on the Turn
Seat 2: Player2 folded before Flop (didn't bet)
Seat 3: Player24 folded before Flop (didn't bet)
Seat 4: Hero (button) folded before Flop (didn't bet)
Seat 5: Player12 (small blind) folded on the Turn
Seat 6: Player22 (big blind) collected ($0.18)
Seat 7: Player8 folded on the Turn
Seat 8: Player3 folded before Flop (didn't bet)
Seat 9: Player9 folded on the Flop



PokerStars Game #24227136121:  Hold'em No Limit ($0.01/$0.02 USD) - 2010/05/06 23:47:50 WET [2010/05/06 18:47:50 ET]
Table '99999999' 9-max Seat #5 is the button
Seat 1: Player20 ($5.08 in chips) 
Seat 2: Player2 ($0.98 in chips) 
Seat 3: Player24 ($1.52 in chips) 
Seat 4: Hero ($3.98 in chips) 
Seat 5: Player12 ($0.74 in chips) 
Seat 6: Player22 ($1.78 in chips) 
Seat 7: Player8 ($1.07 in chips) 
Seat 8: Player3 ($3 in chips) 
Seat 9: Player9 ($3.86 in chips) 
Player22: posts small blind $0.01
Player8: posts big blind $0.02
*** HOLE CARDS ***
Dealt to Hero [Kc 7s]
Player3: folds 
Player9: folds 
Player20: calls $0.02
Player2: folds 
Player24: folds 
Hero: folds 
Player12: calls $0.02
Player22: folds 
Player8: checks 
*** FLOP *** [Th 5d 7h]
Player8: checks 
Player20: checks 
Player12: checks 
*** TURN *** [Th 5d 7h] [6s]
Player8: checks 
Player20: checks 
Player12: checks 
*** RIVER *** [Th 5d 7h 6s] [8s]
Player8: checks 
Player20: bets $0.04
Player12: folds 
Player8: folds 
Uncalled bet ($0.04) returned to Player20
Player20 collected $0.07 from pot
Player20: doesn't show hand 
*** SUMMARY ***
Total pot $0.07 | Rake $0 
Board [Th 5d 7h 6s 8s]
Seat 1: Player20 collected ($0.07)
Seat 2: Player2 folded before Flop (didn't bet)
Seat 3: Player24 folded before Flop (didn't bet)
Seat 4: Hero folded before Flop (didn't bet)
Seat 5: Player12 (button) folded on the River
Seat 6: Player22 (small blind) folded before Flop
Seat 7: Player8 (big blind) folded on the River
Seat 8: Player3 folded before Flop (didn't bet)
Seat 9: Player9 folded before Flop (didn't bet)



PokerStars Game #31395250833:  Hold'em No Limit ($0.01/$0.02 USD) - 2010/05/06 23:48:42 WET [2010/05/06 18:48:42 ET]
Table '99999999' 9-max Seat #6 is the button
Seat 1: Player20 ($5.13 in chips) 
Seat 2: Player2 ($0.98 in chips) 
Seat 3: Player24 ($1.52 in chips) 
Seat 4: Hero ($3.98 in chips) 
Seat 5: Player12 ($0.72 in chips) 
Seat 6: Player22 ($1.77 in chips) 
Seat 7: Player8 ($1.05 in chips) 
Seat 9: Player9 ($3.86 in chips) 
Player8: posts small blind $0.01
Player3: is sitting out 
Player9: posts big blind $0.02
*** HOLE CARDS ***
Dealt to Hero [Ah 2c]
Player20: folds 
Player2: calls $0.02
Player3 leaves the table
Player24: folds 
Hero: folds 
Player12: raises $0.06 to $0.08
Player22: calls $0.08
Player8: calls $0.07
Player9: folds 
Player2: calls $0.06
*** FLOP *** [6h Js 3h]
Player8: checks 
Player2: bets $0.90 and is all-in
Player12: folds 
Player22: folds 
Player8: calls $0.90
*** TURN *** [6h Js 3h] [5h]
*** RIVER *** [6h Js 3h 5h] [8d]
*** SHOW DOWN ***
Player8: shows [6s 9s] (a pair of Sixes)
Player2: shows [Qc Jd] (a pair of Jacks)
Player2 collected $2.04 from pot
*** SUMMARY ***
Total pot $2.14 | Rake $0.10 
Board [6h Js 3h 5h 8d]
Seat 1: Player20 folded before Flop (didn't bet)
Seat 2: Player2 showed [Qc Jd] and won ($2.04) with a pair of Jacks
Seat 3: Player24 folded before Flop (didn't bet)
Seat 4: Hero folded before Flop (didn't bet)
Seat 5: Player12 folded on the Flop
Seat 6: Player22 (button) folded on the Flop
Seat 7: Player8 (small blind) showed [6s 9s] and lost with a pair of Sixes
Seat 9: Player9 (big blind) folded before Flop



PokerStars Game #12179306192:  Hold'em No Limit ($0.01/$0.02 USD) - 2010/05/06 23:49:27 WET [2010/05/06 18:49:27 ET]
Table '99999999' 9-max Seat #7 is the button
Seat 1: Player20 ($5.13 in chips) 
Seat 2: Player2 ($2.04 in chips) 
Seat 3: Player24 ($1.52 in chips) 
Seat 4: Hero ($3.98 in chips) 
Seat 5: Player12 ($0.64 in chips) 
Seat 6: Player22 ($1.69 in chips) 
Seat 7: Player8 ($0.07 in chips) 
Seat 9: Player9 ($3.84 in chips) 
Player9: posts small blind $0.01
Player20: posts big blind $0.02
*** HOLE CARDS ***
Dealt to Hero [Ks 9d]
Player2: raises $0.06 to $0.08
Player24: folds 
Hero: folds 
Player12: folds 
Player22: folds 
Player8: folds 
Player9: calls $0.07
Player20: folds 
*** FLOP *** [Js Tc 8s]
Player9: bets $0.04
Player2: raises $0.12 to $0.16
Player9: calls $0.12
*** TURN *** [Js Tc 8s] [Ad]
Player9: bets $0.10
Player2: raises $1.70 to $1.80 and is all-in
Player9: folds 
Uncalled bet ($1.70) returned to Player2
Player2 collected $0.70 from pot
*** SUMMARY ***
Total pot $0.70 | Rake $0 
Board [Js Tc 8s Ad]
Seat 1: Player20 (big blind) folded before Flop
Seat 2: Player2 collected ($0.70)
Seat 3: Player24 folded before Flop (didn't bet)
Seat 4: Hero folded before Flop (didn't bet)
Seat 5: Player12 folded before Flop (didn't bet)
Seat 6: Player22 folded before Flop (didn't bet)
Seat 7: Player8 (button) folded before Flop (didn't bet)
Seat 9: Player9 (small blind) folded on the Turn



PokerStars Game #51091236980:  Hold'em No Limit ($0.01/$0.02 USD) - 2010/05/06 23:50:39 WET [2010/05/06 18:50:39 ET]
Table '99999999' 9-max Seat #9 is the button
Seat 1: Player20 ($5.11 in chips) 
Seat 2: Player2 ($2.40 in chips) 
Seat 3: Player24 ($1.52 in chips) 
Seat 4: Hero ($3.98 in chips) 
Seat 5: Player12 ($0.64 in chips) 
Seat 6: Player22 ($1.69 in chips) 
Seat 7: Player8 ($0.07 in chips) 
Seat 9: Player9 ($3.50 in chips) 
Player20: posts small blind $0.01
Player2: posts big blind $0.02
*** HOLE CARDS ***
Dealt to Hero [Ad 4s]
Player24: folds 
Hero: raises $0.04 to $0.06
Player12: calls $0.06
Player22: folds 
Player8: folds 
Player9: calls $0.06
Player20: folds 
Player2: folds 
*** FLOP *** [As 6c 5c]
Hero: bets $0.08
Player12: calls $0.08
Player9: raises $0.08 to $0.16
Hero: folds 
Player12: raises $0.42 to $0.58 and is all-in
Player9: calls $0.42
*** TURN *** [As 6c 5c] [Qd]
*** RIVER *** [As 6c 5c Qd] [9d]
*** SHOW DOWN ***
Player12: shows [Ac Tc] (a pair of Aces)
Player9: mucks hand 
Player12 collected $1.40 from pot
*** SUMMARY ***
Total pot $1.45 | Rake $0.05 
Board [As 6c 5c Qd 9d]
Seat 1: Player20 (small blind) folded before Flop
Seat 2: Player2 (big blind) folded before Flop
Seat 3: Player24 folded before Flop (didn't bet)
Seat 4: Hero folded on the Flop
Seat 5: Player12 showed [Ac Tc] and won ($1.40) with a pair of Aces
Seat 6: Player22 folded before Flop (didn't bet)
Seat 7: Player8 folded before Flop (didn't bet)
Seat 9: Player9 (button) mucked [8d Ah]



PokerStars Game #27086240062:  Hold'em No Limit ($0.01/$0.02 USD) - 2010/05/06 23:51:46 WET [2010/05/06 18:51:46 ET]
Table '99999999' 9-max Seat #1 is the button
Seat 1: Player20 ($5.10 in chips) 
Seat 2: Player2 ($2.38 in chips) 
Seat 3: Player24 ($1.52 in chips) 
Seat 4: Hero ($3.84 in chips) 
Seat 5: Player12 ($1.40 in chips) 
Seat 6: Player22 ($1.69 in chips) 
Seat 7: Player8 ($0.07 in chips) 
Seat 9: Player9 ($2.86 in chips) 
Player2: posts small blind $0.01
Player24: posts big blind $0.02
*** HOLE CARDS ***
Dealt to Hero [5c 5d]
Hero: raises $0.04 to $0.06
Player12: folds 
Player22: folds 
Player8: folds 
Player9: folds 
Player20: calls $0.06
Player2: folds 
Player24: folds 
*** FLOP *** [7d 4s 8h]
Player2 leaves the table
Hero: checks 
Player20: checks 
*** TURN *** [7d 4s 8h] [Th]
Hero: checks 
Player13 joins the table at seat #8 
Player20: bets $0.08
Hero: raises $0.12 to $0.20
Player20: calls $0.12
*** RIVER *** [7d 4s 8h Th] [4h]
Hero: checks 
Player20: checks 
*** SHOW DOWN ***
Hero: shows [5c 5d] (two pair, Fives and Fours)
Player20: shows [Jc Tc] (two pair, Tens and Fours)
Player20 collected $0.55 from pot
*** SUMMARY ***
Total pot $0.55 | Rake $0 
Board [7d 4s 8h Th 4h]
Seat 1: Player20 (button) showed [Jc Tc] and won ($0.55) with two pair, Tens and Fours
Seat 2: Player2 (small blind) folded before Flop
Seat 3: Player24 (big blind) folded before Flop
Seat 4: Hero showed [5c 5d] and lost with two pair, Fives and Fours
Seat 5: Player12 folded before Flop (didn't bet)
Seat 6: Player22 folded before Flop (didn't bet)
Seat 7: Player8 folded before Flop (didn't bet)
Seat 9: Player9 folded before Flop (didn't bet)



PokerStars Game #25223712121:  Hold'em No Limit ($0.01/$0.02 USD) - 2010/05/06 23:52:23 WET [2010/05/06 18:52:23 ET]
Table '99999999' 9-max Seat #3 is the button
Seat 1: Player20 ($5.39 in chips) 
Seat 3: Player24 ($1.50 in chips) 
Seat 4: Hero ($3.58 in chips) 
Seat 5: Player12 ($1.40 in chips) 
Seat 6: Player22 ($1.69 in chips) 
Seat 7: Player8 ($0.07 in chips) 
Seat 9: Player9 ($2.86 in chips) 
Hero: posts small blind $0.01
Player12: posts big blind $0.02
Player13: sits out 
*** HOLE CARDS ***
Dealt to Hero [Kd 7d]
Player22: calls $0.02
Player8: folds 
Player10 joins the table at seat #2 
Player9: folds 
Player20: folds 
Player24: calls $0.02
Hero: calls $0.01
Player12: checks 
*** FLOP *** [6s 9d 6d]
Hero: bets $0.08
Player12: folds 
Player22: calls $0.08
Player24: folds 
*** TURN *** [6s 9d 6d] [2c]
Hero: checks 
Player22: checks 
*** RIVER *** [6s 9d 6d 2c] [8h]
Hero: checks 
Player22: checks 
*** SHOW DOWN ***
Hero: shows [Kd 7d] (a pair of Sixes)
Player22: shows [5h 5s] (two pair, Sixes and Fives)
Player22 collected $0.24 from pot
*** SUMMARY ***
Total pot $0.24 | Rake $0 
Board [6s 9d 6d 2c 8h]
Seat 1: Player20 folded before Flop (didn't bet)
Seat 3: Player24 (button) folded on the Flop
Seat 4: Hero (small blind) showed [Kd 7d] and lost with a pair of Sixes
Seat 5: Player12 (big blind) folded on the Flop
Seat 6: Player22 showed [5h 5s] and won ($0.24) with two pair, Sixes and Fives
Seat 7: Player8 folded before Flop (didn't bet)
Seat 9: Player9 folded before Flop (didn't bet)



PokerStars Game #73402790620:  Hold'em No Limit ($0.01/$0.02 USD) - 2010/05/06 23:53:15 WET [2010/05/06 18:53:15 ET]
Table '99999999' 9-max Seat #4 is the button
Seat 1: Player20 ($5.39 in chips) 
Seat 3: Player24 ($1.48 in chips) 
Seat 4: Hero ($3.48 in chips) 
Seat 5: Player12 ($1.38 in chips) 
Seat 6: Player22 ($1.83 in chips) 
Seat 7: Player8 ($0.07 in chips) 
Seat 8: Player13 ($5 in chips) 
Seat 9: Player9 ($2.86 in chips) 
Player12: posts small blind $0.01
Player22: posts big blind $0.02
Player13: posts big blind $0.02
Player10: sits out 
*** HOLE CARDS ***
Dealt to Hero [5d 7c]
Player8: folds 
Player13: checks 
Player9: folds 
Player20: folds 
Player24: folds 
Hero: calls $0.02
Player12: calls $0.01
Player22: checks 
*** FLOP *** [7d Kd Jh]
Player12: checks 
Player22: checks 
Player13: checks 
Hero: checks 
*** TURN *** [7d Kd Jh] [7s]
Player12: checks 
Player22: checks 
Player13: checks 
Hero: bets $0.08
Player12: folds 
Player22: folds 
Player13: folds 
Uncalled bet ($0.08) returned to Hero
Hero collected $0.08 from pot
Hero: doesn't show hand 
*** SUMMARY ***
Total pot $0.08 | Rake $0 
Board [7d Kd Jh 7s]
Seat 1: Player20 folded before Flop (didn't bet)
Seat 3: Player24 folded before Flop (didn't bet)
Seat 4: Hero (button) collected ($0.08)
Seat 5: Player12 (small blind) folded on the Turn
Seat 6: Player22 (big blind) folded on the Turn
Seat 7: Player8 folded before Flop (didn't bet)
Seat 8: Player13 folded on the Turn
Seat 9: Player9 folded before Flop (didn't bet)



PokerStars Game #76511550927:  Hold'em No Limit ($0.01/$0.02 USD) - 2010/05/06 23:54:00 WET [2010/05/06 18:54:00 ET]
Table '99999999' 9-max Seat #5 is the button
Seat 1: Player20 ($5.39 in chips) 
Seat 2: Player10 ($1.29 in chips) 
Seat 3: Player24 ($1.48 in chips) 
Seat 4: Hero ($3.54 in chips) 
Seat 5: Player12 ($1.36 in chips) 
Seat 6: Player22 ($1.81 in chips) 
Seat 7: Player8 ($0.07 in chips) 
Seat 8: Player13 ($4.98 in chips) 
Seat 9: Player9 ($2.86 in chips) 
Player22: posts small blind $0.01
Player8: posts big blind $0.02
Player10: posts big blind $0.02
*** HOLE CARDS ***
Dealt to Hero [8d Js]
Player13: folds 
Player9: folds 
Player20: folds 
Player10: checks 
Player24: folds 
Hero: raises $0.06 to $0.08
Player12: calls $0.08
Player22: calls $0.07
Player8: calls $0.05 and is all-in
Player10: calls $0.06
*** FLOP *** [9c 9s Ah]
Player22: bets $0.04
Player10: folds 
Hero: folds 
Player12: calls $0.04
*** TURN *** [9c 9s Ah] [Td]
Player22: bets $0.08
Player12: folds 
Uncalled bet ($0.08) returned to Player22
*** RIVER *** [9c 9s Ah Td] [3d]
*** SHOW DOWN ***
Player22: shows [Ac 6c] (two pair, Aces and Nines)
Player22 collected $0.12 from side pot
Player8: shows [Kh Th] (two pair, Tens and Nines)
Player22 collected $0.35 from main pot
*** SUMMARY ***
Total pot $0.47 Main pot $0.35. Side pot $0.12. | Rake $0 
Board [9c 9s Ah Td 3d]
Seat 1: Player20 folded before Flop (didn't bet)
Seat 2: Player10 folded on the Flop
Seat 3: Player24 folded before Flop (didn't bet)
Seat 4: Hero folded on the Flop
Seat 5: Player12 (button) folded on the Turn
Seat 6: Player22 (small blind) showed [Ac 6c] and won ($0.47) with two pair, Aces and Nines
Seat 7: Player8 (big blind) showed [Kh Th] and lost with two pair, Tens and Nines
Seat 8: Player13 folded before Flop (didn't bet)
Seat 9: Player9 folded before Flop (didn't bet)



PokerStars Game #28012101373:  Hold'em No Limit ($0.01/$0.02 USD) - 2010/05/06 23:54:56 WET [2010/05/06 18:54:56 ET]
Table '99999999' 9-max Seat #6 is the button
Seat 1: Player20 ($5.39 in chips) 
Seat 2: Player10 ($1.21 in chips) 
Seat 3: Player24 ($1.48 in chips) 
Seat 4: Hero ($3.46 in chips) 
Seat 5: Player12 ($1.24 in chips) 
Seat 6: Player22 ($2.16 in chips) 
Seat 8: Player13 ($4.98 in chips) 
Seat 9: Player9 ($2.86 in chips) 
Player13: posts small blind $0.01
Player9: posts big blind $0.02
*** HOLE CARDS ***
Dealt to Hero [7s 5h]
Player20: folds 
Player10: calls $0.02
Player8 leaves the table
Player24: folds 
Hero: calls $0.02
Player12: calls $0.02
Player22: folds 
Player13: folds 
Player9: checks 
*** FLOP *** [5s 8d Kc]
Player9: checks 
Player10: bets $0.06
Hero: raises $0.08 to $0.14
Player12: folds 
Player9: folds 
Player10: calls $0.08
*** TURN *** [5s 8d Kc] [4c]
Player10: checks 
Player13 leaves the table
Hero: checks 
*** RIVER *** [5s 8d Kc 4c] [3s]
Player10: checks 
Player7 joins the table at seat #8 
Hero: checks 
*** SHOW DOWN ***
Player10: shows [2c 2h] (a pair of Deuces)
Hero: shows [7s 5h] (a pair of Fives)
Hero collected $0.37 from pot
*** SUMMARY ***
Total pot $0.37 | Rake $0 
Board [5s 8d Kc 4c 3s]
Seat 1: Player20 folded before Flop (didn't bet)
Seat 2: Player10 showed [2c 2h] and lost with a pair of Deuces
Seat 3: Player24 folded before Flop (didn't bet)
Seat 4: Hero showed [7s 5h] and won ($0.37) with a pair of Fives
Seat 5: Player12 folded on the Flop
Seat 6: Player22 (button) folded before Flop (didn't bet)
Seat 8: Player13 (small blind) folded before Flop
Seat 9: Player9 (big blind) folded on the Flop



PokerStars Game #41511921426:  Hold'em No Limit ($0.01/$0.02 USD) - 2010/05/06 23:55:56 WET [2010/05/06 18:55:56 ET]
Table '99999999' 9-max Seat #9 is the button
Seat 1: Player20 ($5.39 in chips) 
Seat 2: Player10 ($1.05 in chips) 
Seat 3: Player24 ($1.48 in chips) 
Seat 4: Hero ($3.67 in chips) 
Seat 5: Player12 ($1.22 in chips) 
Seat 9: Player9 ($2.84 in chips) 
Player20: posts small blind $0.01
Player10: posts big blind $0.02
Player7: sits out 
*** HOLE CARDS ***
Dealt to Hero [Js 6c]
Player24: folds 
Hero: folds 
Player12: folds 
Player9: calls $0.02
Player20: raises $0.04 to $0.06
Player10: raises $0.04 to $0.10
Player9: calls $0.08
Player20: raises $0.30 to $0.40
Player10: raises $0.30 to $0.70
Player9: calls $0.60
Player20: raises $4.69 to $5.39 and is all-in
Player10: calls $0.35 and is all-in
Player9: calls $2.14 and is all-in
Uncalled bet ($2.55) returned to Player20
*** FLOP *** [2c 2s Ts]
*** TURN *** [2c 2s Ts] [Kd]
*** RIVER *** [2c 2s Ts Kd] [9s]
*** SHOW DOWN ***
Player20: shows [Ad Ah] (two pair, Aces and Deuces)
Player9: shows [Qs 7h] (a pair of Deuces)
Player20 collected $3.43 from side pot
Player10: shows [Kh Ks] (a full house, Kings full of Deuces)
Player10 collected $3 from main pot
*** SUMMARY ***
Total pot $6.73 Main pot $3. Side pot $3.43. | Rake $0.30 
Board [2c 2s Ts Kd 9s]
Seat 1: Player20 (small blind) showed [Ad Ah] and won ($3.43) with two pair, Aces and Deuces
Seat 2: Player10 (big blind) showed [Kh Ks] and won ($3) with a full house, Kings full of Deuces
Seat 3: Player24 folded before Flop (didn't bet)
Seat 4: Hero folded before Flop (didn't bet)
Seat 5: Player12 folded before Flop (didn't bet)
Seat 9: Player9 (button) showed [Qs 7h] and lost with a pair of Deuces



PokerStars Game #28359136208:  Hold'em No Limit ($0.01/$0.02 USD) - 2010/05/06 23:56:53 WET [2010/05/06 18:56:53 ET]
Table '99999999' 9-max Seat #1 is the button
Seat 1: Player20 ($5.98 in chips) 
Seat 2: Player10 ($3 in chips) 
Seat 3: Player24 ($1.48 in chips) 
Seat 4: Hero ($3.67 in chips) 
Seat 5: Player12 ($1.22 in chips) 
Player10: posts small blind $0.01
Player24: posts big blind $0.02
Player7: sits out 
*** HOLE CARDS ***
Dealt to Hero [6c Tc]
Hero: raises $0.04 to $0.06
Player12: folds 
Player16 joins the table at seat #7 
Player20 said, "lol everytime"
Player20: folds 
Player10: raises $0.04 to $0.10
Player24: folds 
Hero: calls $0.04
*** FLOP *** [5c Kc Jh]
Player10: checks 
Hero: bets $0.08
Player10: calls $0.08
*** TURN *** [5c Kc Jh] [5h]
Player10: checks 
Hero: checks 
*** RIVER *** [5c Kc Jh 5h] [Ts]
Player10: checks 
Hero: checks 
*** SHOW DOWN ***
Player10: shows [Ad Ac] (two pair, Aces and Fives)
Hero: mucks hand 
Player10 collected $0.38 from pot
*** SUMMARY ***
Total pot $0.38 | Rake $0 
Board [5c Kc Jh 5h Ts]
Seat 1: Player20 (button) folded before Flop (didn't bet)
Seat 2: Player10 (small blind) showed [Ad Ac] and won ($0.38) with two pair, Aces and Fives
Seat 3: Player24 (big blind) folded before Flop
Seat 4: Hero mucked [6c Tc]
Seat 5: Player12 folded before Flop (didn't bet)



PokerStars Game #70913060022:  Hold'em No Limit ($0.01/$0.02 USD) - 2010/05/06 23:57:35 WET [2010/05/06 18:57:35 ET]
Table '99999999' 9-max Seat #2 is the button
Seat 1: Player20 ($5.98 in chips) 
Seat 2: Player10 ($3.20 in chips) 
Seat 3: Player24 ($1.46 in chips) 
Seat 4: Hero ($3.49 in chips) 
Seat 5: Player12 ($1.22 in chips) 
Seat 9: Player9 ($1.80 in chips) 
Player24: posts small blind $0.01
Hero: posts big blind $0.02
Player16: sits out 
Player7: sits out 
*** HOLE CARDS ***
Dealt to Hero [As 7h]
Player12: calls $0.02
Player20 said, "haha nice"
Player9: calls $0.02
Player20: calls $0.02
Player10: calls $0.02
Player24: calls $0.01
Hero: checks 
*** FLOP *** [Qs Qh Ad]
Player24: checks 
Hero: bets $0.12
Player12: folds 
Player9: calls $0.12
Player20: folds 
Player10: folds 
Player24: folds 
*** TURN *** [Qs Qh Ad] [5h]
Hero: bets $0.10
Player9: calls $0.10
*** RIVER *** [Qs Qh Ad 5h] [Ah]
Hero: bets $0.12
Player9: raises $1.44 to $1.56 and is all-in
Hero: calls $1.44
*** SHOW DOWN ***
Player9: shows [Kh Jh] (a flush, Ace high)
Hero: shows [As 7h] (a full house, Aces full of Queens)
Hero collected $3.53 from pot
*** SUMMARY ***
Total pot $3.68 | Rake $0.15 
Board [Qs Qh Ad 5h Ah]
Seat 1: Player20 folded on the Flop
Seat 2: Player10 (button) folded on the Flop
Seat 3: Player24 (small blind) folded on the Flop
Seat 4: Hero (big blind) showed [As 7h] and won ($3.53) with a full house, Aces full of Queens
Seat 5: Player12 folded on the Flop
Seat 9: Player9 showed [Kh Jh] and lost with a flush, Ace high



PokerStars Game #20264306210:  Hold'em No Limit ($0.01/$0.02 USD) - 2010/05/06 23:58:36 WET [2010/05/06 18:58:36 ET]
Table '99999999' 9-max Seat #3 is the button
Seat 1: Player20 ($5.96 in chips) 
Seat 2: Player10 ($3.18 in chips) 
Seat 3: Player24 ($1.44 in chips) 
Seat 4: Hero ($5.22 in chips) 
Seat 5: Player12 ($1.20 in chips) 
Seat 6: Player22 ($2.16 in chips) 
Hero: posts small blind $0.01
Player12: posts big blind $0.02
Player16: sits out 
Player7: sits out 
*** HOLE CARDS ***
Dealt to Hero [Ac 7s]
Player22: folds 
Player20: folds 
Player10: folds 
Player24: folds 
Player22 said, "nh"
Hero: raises $0.08 to $0.10
Player12: calls $0.08
*** FLOP *** [8c 5d Qh]
Hero said, "tyty"
Hero: checks 
Player12: checks 
*** TURN *** [8c 5d Qh] [Tc]
Hero: checks 
Player12: bets $0.10
Hero: folds 
Uncalled bet ($0.10) returned to Player12
Player12 collected $0.20 from pot
*** SUMMARY ***
Total pot $0.20 | Rake $0 
Board [8c 5d Qh Tc]
Seat 1: Player20 folded before Flop (didn't bet)
Seat 2: Player10 folded before Flop (didn't bet)
Seat 3: Player24 (button) folded before Flop (didn't bet)
Seat 4: Hero (small blind) folded on the Turn
Seat 5: Player12 (big blind) collected ($0.20)
Seat 6: Player22 folded before Flop (didn't bet)



PokerStars Game #27816107382:  Hold'em No Limit ($0.01/$0.02 USD) - 2010/05/06 23:59:12 WET [2010/05/06 18:59:12 ET]
Table '99999999' 9-max Seat #4 is the button
Seat 1: Player20 ($5.96 in chips) 
Seat 2: Player10 ($3.18 in chips) 
Seat 3: Player24 ($1.44 in chips) 
Seat 4: Hero ($5.12 in chips) 
Seat 5: Player12 ($1.30 in chips) 
Seat 6: Player22 ($2.16 in chips) 
Player12: posts small blind $0.01
Player22: posts big blind $0.02
Player16: sits out 
Player7: sits out 
*** HOLE CARDS ***
Dealt to Hero [As Qc]
Player20: folds 
Player10: calls $0.02
Player24: folds 
Hero: calls $0.02
Player12: calls $0.01
Player22: checks 
*** FLOP *** [8s 8h Kd]
Player12: checks 
Player22: checks 
Player10: checks 
Hero: checks 
*** TURN *** [8s 8h Kd] [9h]
Player12: bets $0.06
Player22: folds 
Player10: calls $0.06
Hero: folds 
*** RIVER *** [8s 8h Kd 9h] [6s]
Player12: bets $0.24
Player10: folds 
Uncalled bet ($0.24) returned to Player12
Player12 collected $0.20 from pot
Player10 leaves the table
*** SUMMARY ***
Total pot $0.20 | Rake $0 
Board [8s 8h Kd 9h 6s]
Seat 1: Player20 folded before Flop (didn't bet)
Seat 2: Player10 folded on the River
Seat 3: Player24 folded before Flop (didn't bet)
Seat 4: Hero (button) folded on the Turn
Seat 5: Player12 (small blind) collected ($0.20)
Seat 6: Player22 (big blind) folded on the Turn



PokerStars Game #25404395119:  Hold'em No Limit ($0.01/$0.02 USD) - 2010/05/07 0:00:03 WET [2010/05/06 19:00:03 ET]
Table '99999999' 9-max Seat #5 is the button
Seat 1: Player20 ($5.96 in chips) 
Seat 3: Player24 ($1.44 in chips) 
Seat 4: Hero ($5.10 in chips) 
Seat 5: Player12 ($1.42 in chips) 
Seat 6: Player22 ($2.14 in chips) 
Seat 7: Player16 ($1.60 in chips) 
Seat 9: Player9 ($1 in chips) 
Player22: posts small blind $0.01
Player16: posts big blind $0.02
Player7: sits out 
*** HOLE CARDS ***
Dealt to Hero [5c 8c]
Player9: calls $0.02
Player20: folds 
Player24: folds 
Hero: calls $0.02
Player12: calls $0.02
Player22: folds 
Player16: checks 
*** FLOP *** [Ad Kd Qh]
Player16: checks 
Player9: checks 
Hero: checks 
Player12: checks 
*** TURN *** [Ad Kd Qh] [9c]
Player16: checks 
Player9: bets $0.02
Hero: folds 
Player12: calls $0.02
Player16: folds 
*** RIVER *** [Ad Kd Qh 9c] [7d]
Player9: checks 
Player4 joins the table at seat #2 
Player12: checks 
*** SHOW DOWN ***
Player9: shows [6c Jd] (high card Ace)
Player12: shows [5h Kh] (a pair of Kings)
Player12 collected $0.13 from pot
*** SUMMARY ***
Total pot $0.13 | Rake $0 
Board [Ad Kd Qh 9c 7d]
Seat 1: Player20 folded before Flop (didn't bet)
Seat 3: Player24 folded before Flop (didn't bet)
Seat 4: Hero folded on the Turn
Seat 5: Player12 (button) showed [5h Kh] and won ($0.13) with a pair of Kings
Seat 6: Player22 (small blind) folded before Flop
Seat 7: Player16 (big blind) folded on the Turn
Seat 9: Player9 showed [6c Jd] and lost with high card Ace



PokerStars Game #19191328622:  Hold'em No Limit ($0.01/$0.02 USD) - 2010/05/07 0:02:07 WET [2010/05/06 19:02:07 ET]
Table '99999999' 9-max Seat #7 is the button
Seat 1: Player20 ($5.94 in chips) 
Seat 3: Player24 ($1.44 in chips) 
Seat 4: Hero ($5.08 in chips) 
Seat 5: Player12 ($1.15 in chips) 
Seat 6: Player22 ($2.56 in chips) 
Seat 7: Player16 ($1.57 in chips) 
Seat 8: Player7 ($2 in chips) 
Seat 9: Player9 ($0.94 in chips) 
Player7: posts small blind $0.01
Player9: posts big blind $0.02
Player4: sits out 
*** HOLE CARDS ***
Dealt to Hero [4h As]
Player20: folds 
Player24: folds 
Hero: folds 
Player12: calls $0.02
Player22: calls $0.02
Player16: folds 
Player7: calls $0.01
Player9: checks 
*** FLOP *** [Qh 5c 9c]
Player7: checks 
Player9: checks 
Player12: checks 
Player22: checks 
*** TURN *** [Qh 5c 9c] [7d]
Player7: checks 
Player9: checks 
Player12: checks 
Player22: checks 
*** RIVER *** [Qh 5c 9c 7d] [Qd]
Player7: checks 
Player9: checks 
Player12: checks 
Player22: checks 
*** SHOW DOWN ***
Player7: shows [4s 5s] (two pair, Queens and Fives)
Player9: mucks hand 
Player12: mucks hand 
Player22: mucks hand 
Player7 collected $0.08 from pot
*** SUMMARY ***
Total pot $0.08 | Rake $0 
Board [Qh 5c 9c 7d Qd]
Seat 1: Player20 folded before Flop (didn't bet)
Seat 3: Player24 folded before Flop (didn't bet)
Seat 4: Hero folded before Flop (didn't bet)
Seat 5: Player12 mucked [3h 2s]
Seat 6: Player22 mucked [Ts 6s]
Seat 7: Player16 (button) folded before Flop (didn't bet)
Seat 8: Player7 (small blind) showed [4s 5s] and won ($0.08) with two pair, Queens and Fives
Seat 9: Player9 (big blind) mucked [6c 2d]



PokerStars Game #35042386427:  Hold'em No Limit ($0.01/$0.02 USD) - 2010/05/07 0:03:47 WET [2010/05/06 19:03:47 ET]
Table '99999999' 9-max Seat #8 is the button
Seat 1: Player20 ($5.94 in chips) 
Seat 3: Player24 ($1.44 in chips) 
Seat 4: Hero ($5.08 in chips) 
Seat 5: Player12 ($1.13 in chips) 
Seat 6: Player22 ($2.54 in chips) 
Seat 7: Player16 ($1.57 in chips) 
Seat 8: Player7 ($2.06 in chips) 
Seat 9: Player9 ($0.92 in chips) 
Player9: posts small blind $0.01
Player20: posts big blind $0.02
Player4: sits out 
*** HOLE CARDS ***
Dealt to Hero [5s Ks]
Player24: folds 
Hero: folds 
Player12: calls $0.02
Player22: folds 
Player16: folds 
Player7: calls $0.02
Player9: calls $0.01
Player20: checks 
*** FLOP *** [Qc 9c 5h]
Player9: checks 
Player20: checks 
Player12: checks 
Player7: bets $0.06
Player9: calls $0.06
Player20: folds 
Player12: calls $0.06
*** TURN *** [Qc 9c 5h] [Td]
Player9: checks 
Player12: checks 
Player7: checks 
*** RIVER *** [Qc 9c 5h Td] [Jh]
Player9: bets $0.20
Player12: folds 
Player7: folds 
Uncalled bet ($0.20) returned to Player9
Player9 collected $0.26 from pot
*** SUMMARY ***
Total pot $0.26 | Rake $0 
Board [Qc 9c 5h Td Jh]
Seat 1: Player20 (big blind) folded on the Flop
Seat 3: Player24 folded before Flop (didn't bet)
Seat 4: Hero folded before Flop (didn't bet)
Seat 5: Player12 folded on the River
Seat 6: Player22 folded before Flop (didn't bet)
Seat 7: Player16 folded before Flop (didn't bet)
Seat 8: Player7 (button) folded on the River
Seat 9: Player9 (small blind) collected ($0.26)



PokerStars Game #50092600346:  Hold'em No Limit ($0.01/$0.02 USD) - 2010/05/07 0:05:36 WET [2010/05/06 19:05:36 ET]
Table '99999999' 9-max Seat #9 is the button
Seat 1: Player20 ($5.92 in chips) 
Seat 2: Player4 ($1 in chips) 
Seat 3: Player24 ($1.44 in chips) 
Seat 4: Hero ($5.08 in chips) 
Seat 5: Player12 ($1.05 in chips) 
Seat 6: Player22 ($2.54 in chips) 
Seat 7: Player16 ($1.57 in chips) 
Seat 8: Player7 ($2 in chips) 
Seat 9: Player9 ($1.10 in chips) 
Player20: posts small blind $0.01
Player4: posts big blind $0.02
*** HOLE CARDS ***
Dealt to Hero [Ts 8s]
Player24: folds 
Hero: calls $0.02
Player12: calls $0.02
Player22: calls $0.02
Player16: calls $0.02
Player7: calls $0.02
Player9: folds 
Player20: calls $0.01
Player4: checks 
*** FLOP *** [9d 3c Js]
Player20: checks 
Player4: checks 
Hero: checks 
Player12: checks 
Player22: checks 
Player16: bets $0.10
Player7: folds 
Player20: calls $0.10
Player4: calls $0.10
Hero: calls $0.10
Player12: folds 
Player22: folds 
*** TURN *** [9d 3c Js] [Qh]
Player20: checks 
Player4: checks 
Hero: checks 
Player16: checks 
*** RIVER *** [9d 3c Js Qh] [2s]
Player20: bets $0.26
Player4: folds 
Hero: calls $0.26
Player16: folds 
*** SHOW DOWN ***
Player20: shows [2h Jh] (two pair, Jacks and Deuces)
Hero: shows [Ts 8s] (a straight, Eight to Queen)
Hero collected $1.01 from pot
*** SUMMARY ***
Total pot $1.06 | Rake $0.05 
Board [9d 3c Js Qh 2s]
Seat 1: Player20 (small blind) showed [2h Jh] and lost with two pair, Jacks and Deuces
Seat 2: Player4 (big blind) folded on the River
Seat 3: Player24 folded before Flop (didn't bet)
Seat 4: Hero showed [Ts 8s] and won ($1.01) with a straight, Eight to Queen
Seat 5: Player12 folded on the Flop
Seat 6: Player22 folded on the Flop
Seat 7: Player16 folded on the River
Seat 8: Player7 folded on the Flop
Seat 9: Player9 (button) folded before Flop (didn't bet)



PokerStars Game #24708132405:  Hold'em No Limit ($0.01/$0.02 USD) - 2010/05/07 0:07:48 WET [2010/05/06 19:07:48 ET]
Table '99999999' 9-max Seat #1 is the button
Seat 1: Player20 ($5.54 in chips) 
Seat 2: Player4 ($0.88 in chips) 
Seat 3: Player24 ($1.44 in chips) 
Seat 4: Hero ($5.71 in chips) 
Seat 5: Player12 ($1.03 in chips) 
Seat 6: Player22 ($2.52 in chips) 
Seat 7: Player16 ($1.45 in chips) 
Seat 8: Player7 ($2 in chips) 
Seat 9: Player9 ($1.10 in chips) 
Player4: posts small blind $0.01
Player24: posts big blind $0.02
*** HOLE CARDS ***
Dealt to Hero [5h Qh]
Hero: folds 
Player12: calls $0.02
Player22: calls $0.02
Player16: folds 
Player7: folds 
Player9: calls $0.02
Player20: folds 
Player4: calls $0.01
Player24: checks 
*** FLOP *** [6c 7s 9h]
Player4: bets $0.02
Player24: calls $0.02
Player12: calls $0.02
Player22: calls $0.02
Player9: calls $0.02
*** TURN *** [6c 7s 9h] [3h]
Player4: bets $0.02
Player24: folds 
Player12: folds 
Player22: calls $0.02
Player9: calls $0.02
*** RIVER *** [6c 7s 9h 3h] [2h]
Player4: checks 
Player22: checks 
Player9: bets $0.02
Player4: folds 
Player22: folds 
Uncalled bet ($0.02) returned to Player9
Player9 collected $0.26 from pot
*** SUMMARY ***
Total pot $0.26 | Rake $0 
Board [6c 7s 9h 3h 2h]
Seat 1: Player20 (button) folded before Flop (didn't bet)
Seat 2: Player4 (small blind) folded on the River
Seat 3: Player24 (big blind) folded on the Turn
Seat 4: Hero folded before Flop (didn't bet)
Seat 5: Player12 folded on the Turn
Seat 6: Player22 folded on the River
Seat 7: Player16 folded before Flop (didn't bet)
Seat 8: Player7 folded before Flop (didn't bet)
Seat 9: Player9 collected ($0.26)



PokerStars Game #16013874820:  Hold'em No Limit ($0.01/$0.02 USD) - 2010/05/07 0:09:23 WET [2010/05/06 19:09:23 ET]
Table '99999999' 9-max Seat #2 is the button
Seat 1: Player20 ($5.54 in chips) 
Seat 2: Player4 ($0.82 in chips) 
Seat 3: Player24 ($1.40 in chips) 
Seat 4: Hero ($5.71 in chips) 
Seat 5: Player12 ($0.99 in chips) 
Seat 6: Player22 ($2.46 in chips) 
Seat 7: Player16 ($1.45 in chips) 
Seat 8: Player7 ($2 in chips) 
Seat 9: Player9 ($1.30 in chips) 
Player24: posts small blind $0.01
Hero: posts big blind $0.02
*** HOLE CARDS ***
Dealt to Hero [5d 7s]
Player12: calls $0.02
Player22: calls $0.02
Player16: folds 
Player7: folds 
Player9: calls $0.02
Player20: calls $0.02
Player4: calls $0.02
Player24: calls $0.01
Hero: checks 
*** FLOP *** [7c Qs Th]
Player24: checks 
Hero: checks 
Player12: checks 
Player22: bets $0.10
Player9: folds 
Player20: folds 
Player4: calls $0.10
Player24: folds 
Hero: folds 
Player12: folds 
*** TURN *** [7c Qs Th] [Qd]
Player22: checks 
Player4: checks 
*** RIVER *** [7c Qs Th Qd] [6h]
Player22: bets $0.50
Player4: folds 
Uncalled bet ($0.50) returned to Player22
Player22 collected $0.34 from pot
Player22: doesn't show hand 
*** SUMMARY ***
Total pot $0.34 | Rake $0 
Board [7c Qs Th Qd 6h]
Seat 1: Player20 folded on the Flop
Seat 2: Player4 (button) folded on the River
Seat 3: Player24 (small blind) folded on the Flop
Seat 4: Hero (big blind) folded on the Flop
Seat 5: Player12 folded on the Flop
Seat 6: Player22 collected ($0.34)
Seat 7: Player16 folded before Flop (didn't bet)
Seat 8: Player7 folded before Flop (didn't bet)
Seat 9: Player9 folded on the Flop



PokerStars Game #81348282228:  Hold'em No Limit ($0.01/$0.02 USD) - 2010/05/07 0:10:43 WET [2010/05/06 19:10:43 ET]
Table '99999999' 9-max Seat #3 is the button
Seat 1: Player20 ($5.52 in chips) 
Seat 2: Player4 ($0.70 in chips) 
Seat 3: Player24 ($1.38 in chips) 
Seat 4: Hero ($5.69 in chips) 
Seat 5: Player12 ($0.97 in chips) 
Seat 6: Player22 ($2.68 in chips) 
Seat 7: Player16 ($1.45 in chips) 
Seat 8: Player7 ($2 in chips) 
Seat 9: Player9 ($1.28 in chips) 
Hero: posts small blind $0.01
Player12: posts big blind $0.02
*** HOLE CARDS ***
Dealt to Hero [As Kd]
Player22: folds 
Player16: folds 
Player7: folds 
Player9: folds 
Player20: folds 
Player4: raises $0.04 to $0.06
Player24: folds 
Hero: calls $0.05
Player12: calls $0.04
*** FLOP *** [Kh 3c Ah]
Hero: checks 
Player12: checks 
Player4: checks 
*** TURN *** [Kh 3c Ah] [Jh]
Hero: checks 
Player12: checks 
Player4: checks 
*** RIVER *** [Kh 3c Ah Jh] [5c]
Hero: checks 
Player12: checks 
Player4: checks 
*** SHOW DOWN ***
Hero: shows [As Kd] (two pair, Aces and Kings)
Player12: mucks hand 
Player4: mucks hand 
Hero collected $0.18 from pot
*** SUMMARY ***
Total pot $0.18 | Rake $0 
Board [Kh 3c Ah Jh 5c]
Seat 1: Player20 folded before Flop (didn't bet)
Seat 2: Player4 mucked [7s 8s]
Seat 3: Player24 (button) folded before Flop (didn't bet)
Seat 4: Hero (small blind) showed [As Kd] and won ($0.18) with two pair, Aces and Kings
Seat 5: Player12 (big blind) mucked [Ts 3s]
Seat 6: Player22 folded before Flop (didn't bet)
Seat 7: Player16 folded before Flop (didn't bet)
Seat 8: Player7 folded before Flop (didn't bet)
Seat 9: Player9 folded before Flop (didn't bet)



PokerStars Game #12247201631:  Hold'em No Limit ($0.01/$0.02 USD) - 2010/05/07 0:11:43 WET [2010/05/06 19:11:43 ET]
Table '99999999' 9-max Seat #4 is the button
Seat 1: Player20 ($5.52 in chips) 
Seat 2: Player4 ($0.64 in chips) 
Seat 3: Player24 ($1.38 in chips) 
Seat 4: Hero ($5.81 in chips) 
Seat 5: Player12 ($0.91 in chips) 
Seat 6: Player22 ($2.68 in chips) 
Seat 7: Player16 ($1.45 in chips) 
Seat 8: Player7 ($2 in chips) 
Seat 9: Player9 ($1.28 in chips) 
Player12: posts small blind $0.01
Player22: posts big blind $0.02
*** HOLE CARDS ***
Dealt to Hero [9s 2d]
Player16: folds 
Player7: folds 
Player9 has timed out
Player9: folds 
Player20: raises $0.04 to $0.06
Player4: folds 
Player24: folds 
Hero: folds 
Player12: folds 
Player22: folds 
Uncalled bet ($0.04) returned to Player20
Player20 collected $0.05 from pot
Player20: doesn't show hand 
*** SUMMARY ***
Total pot $0.05 | Rake $0 
Seat 1: Player20 collected ($0.05)
Seat 2: Player4 folded before Flop (didn't bet)
Seat 3: Player24 folded before Flop (didn't bet)
Seat 4: Hero (button) folded before Flop (didn't bet)
Seat 5: Player12 (small blind) folded before Flop
Seat 6: Player22 (big blind) folded before Flop
Seat 7: Player16 folded before Flop (didn't bet)
Seat 8: Player7 folded before Flop (didn't bet)
Seat 9: Player9 folded before Flop (didn't bet)



PokerStars Game #18249303862:  Hold'em No Limit ($0.01/$0.02 USD) - 2010/05/07 0:12:23 WET [2010/05/06 19:12:23 ET]
Table '99999999' 9-max Seat #5 is the button
Seat 1: Player20 ($5.55 in chips) 
Seat 2: Player4 ($0.64 in chips) 
Seat 3: Player24 ($1.38 in chips) 
Seat 4: Hero ($5.81 in chips) 
Seat 5: Player12 ($0.90 in chips) 
Seat 6: Player22 ($2.66 in chips) 
Seat 7: Player16 ($1.45 in chips) 
Seat 8: Player7 ($2 in chips) 
Seat 9: Player9 ($1.28 in chips) 
Player22: posts small blind $0.01
Player16: posts big blind $0.02
*** HOLE CARDS ***
Dealt to Hero [Kh 5c]
Player7: folds 
Player9: calls $0.02
Player20: folds 
Player4: folds 
Player24: folds 
Hero: folds 
Player12: calls $0.02
Player22: calls $0.01
Player16: checks 
*** FLOP *** [8d 5s Ts]
Player22: checks 
Player16: checks 
Player9: checks 
Player12: checks 
*** TURN *** [8d 5s Ts] [9h]
Player22: bets $0.04
Player16: folds 
Player9: folds 
Player12: folds 
Uncalled bet ($0.04) returned to Player22
Player22 collected $0.08 from pot
Player22: doesn't show hand 
*** SUMMARY ***
Total pot $0.08 | Rake $0 
Board [8d 5s Ts 9h]
Seat 1: Player20 folded before Flop (didn't bet)
Seat 2: Player4 folded before Flop (didn't bet)
Seat 3: Player24 folded before Flop (didn't bet)
Seat 4: Hero folded before Flop (didn't bet)
Seat 5: Player12 (button) folded on the Turn
Seat 6: Player22 (small blind) collected ($0.08)
Seat 7: Player16 (big blind) folded on the Turn
Seat 8: Player7 folded before Flop (didn't bet)
Seat 9: Player9 folded on the Turn



PokerStars Game #79095206106:  Hold'em No Limit ($0.01/$0.02 USD) - 2010/05/07 0:13:34 WET [2010/05/06 19:13:34 ET]
Table '99999999' 9-max Seat #6 is the button
Seat 1: Player20 ($5.55 in chips) 
Seat 2: Player4 ($0.64 in chips) 
Seat 3: Player24 ($1.38 in chips) 
Seat 4: Hero ($5.81 in chips) 
Seat 5: Player12 ($0.88 in chips) 
Seat 6: Player22 ($2.72 in chips) 
Seat 7: Player16 ($1.43 in chips) 
Seat 8: Player7 ($2 in chips) 
Seat 9: Player9 ($1.26 in chips) 
Player16: posts small blind $0.01
Player7: posts big blind $0.02
*** HOLE CARDS ***
Dealt to Hero [Qs 6h]
Player9 has timed out
Player9: folds 
Player20: folds 
Player4: calls $0.02
Player24: calls $0.02
Hero: folds 
Player12: calls $0.02
Player22: calls $0.02
Player16: folds 
Player7: checks 
*** FLOP *** [5d Th 9c]
Player7: checks 
Player4: checks 
Player24: checks 
Player12: bets $0.02
Player22: folds 
Player7: folds 
Player4: folds 
Player24: calls $0.02
*** TURN *** [5d Th 9c] [2d]
Player24: checks 
Player12: checks 
*** RIVER *** [5d Th 9c 2d] [9s]
Player24: checks 
Player12: bets $0.06
Player24: folds 
Uncalled bet ($0.06) returned to Player12
Player12 collected $0.15 from pot
*** SUMMARY ***
Total pot $0.15 | Rake $0 
Board [5d Th 9c 2d 9s]
Seat 1: Player20 folded before Flop (didn't bet)
Seat 2: Player4 folded on the Flop
Seat 3: Player24 folded on the River
Seat 4: Hero folded before Flop (didn't bet)
Seat 5: Player12 collected ($0.15)
Seat 6: Player22 (button) folded on the Flop
Seat 7: Player16 (small blind) folded before Flop
Seat 8: Player7 (big blind) folded on the Flop
Seat 9: Player9 folded before Flop (didn't bet)



PokerStars Game #23803281942:  Hold'em No Limit ($0.01/$0.02 USD) - 2010/05/07 0:15:02 WET [2010/05/06 19:15:02 ET]
Table '99999999' 9-max Seat #7 is the button
Seat 1: Player20 ($5.55 in chips) 
Seat 2: Player4 ($0.62 in chips) 
Seat 3: Player24 ($1.34 in chips) 
Seat 4: Hero ($5.81 in chips) 
Seat 5: Player12 ($0.99 in chips) 
Seat 6: Player22 ($2.70 in chips) 
Seat 7: Player16 ($1.42 in chips) 
Seat 8: Player7 ($2 in chips) 
Seat 9: Player9 ($1.26 in chips) 
Player7: posts small blind $0.01
Player9: posts big blind $0.02
*** HOLE CARDS ***
Dealt to Hero [4d 9d]
Player20: folds 
Player4: folds 
Player24: folds 
Hero: folds 
Player12: folds 
Player22: folds 
Player16: folds 
Player7: raises $0.06 to $0.08
Player9 has timed out
Player9: folds 
Uncalled bet ($0.06) returned to Player7
Player7 collected $0.04 from pot
Player7: doesn't show hand 
*** SUMMARY ***
Total pot $0.04 | Rake $0 
Seat 1: Player20 folded before Flop (didn't bet)
Seat 2: Player4 folded before Flop (didn't bet)
Seat 3: Player24 folded before Flop (didn't bet)
Seat 4: Hero folded before Flop (didn't bet)
Seat 5: Player12 folded before Flop (didn't bet)
Seat 6: Player22 folded before Flop (didn't bet)
Seat 7: Player16 (button) folded before Flop (didn't bet)
Seat 8: Player7 (small blind) collected ($0.04)
Seat 9: Player9 (big blind) folded before Flop



PokerStars Game #29640307323:  Hold'em No Limit ($0.01/$0.02 USD) - 2010/05/07 0:15:57 WET [2010/05/06 19:15:57 ET]
Table '99999999' 9-max Seat #8 is the button
Seat 1: Player20 ($5.55 in chips) 
Seat 2: Player4 ($0.62 in chips) 
Seat 3: Player24 ($1.34 in chips) 
Seat 4: Hero ($5.81 in chips) 
Seat 5: Player12 ($0.99 in chips) 
Seat 6: Player22 ($2.70 in chips) 
Seat 7: Player16 ($1.42 in chips) 
Seat 8: Player7 ($2.02 in chips) 
Player20: posts small blind $0.01
Player4: posts big blind $0.02
*** HOLE CARDS ***
Dealt to Hero [Js 7d]
Player24: folds 
Hero: folds 
Player24 leaves the table
Player12: folds 
Player22: calls $0.02
Player16: folds 
Player1 joins the table at seat #3 
Player7: folds 
Player20: calls $0.01
Player4: checks 
*** FLOP *** [Jc 2d 9d]
Player20: checks 
Player4: checks 
Player22: checks 
*** TURN *** [Jc 2d 9d] [Ac]
Player20: checks 
Player4: checks 
Player22: bets $0.04
Player20: folds 
Player4: folds 
Uncalled bet ($0.04) returned to Player22
Player22 collected $0.06 from pot
Player22: doesn't show hand 
*** SUMMARY ***
Total pot $0.06 | Rake $0 
Board [Jc 2d 9d Ac]
Seat 1: Player20 (small blind) folded on the Turn
Seat 2: Player4 (big blind) folded on the Turn
Seat 3: Player24 folded before Flop (didn't bet)
Seat 4: Hero folded before Flop (didn't bet)
Seat 5: Player12 folded before Flop (didn't bet)
Seat 6: Player22 collected ($0.06)
Seat 7: Player16 folded before Flop (didn't bet)
Seat 8: Player7 (button) folded before Flop (didn't bet)



PokerStars Game #22991200661:  Hold'em No Limit ($0.01/$0.02 USD) - 2010/05/07 0:17:07 WET [2010/05/06 19:17:07 ET]
Table '99999999' 9-max Seat #1 is the button
Seat 1: Player20 ($5.53 in chips) 
Seat 2: Player4 ($0.60 in chips) 
Seat 3: Player1 ($2 in chips) 
Seat 4: Hero ($5.81 in chips) 
Seat 5: Player12 ($0.99 in chips) 
Seat 6: Player22 ($2.74 in chips) 
Seat 7: Player16 ($1.42 in chips) 
Seat 8: Player7 ($2.02 in chips) 
Seat 9: Player9 ($1.24 in chips) 
Player4: posts small blind $0.01
Player1: posts big blind $0.02
Player9: posts small blind $0.01
*** HOLE CARDS ***
Dealt to Hero [9c 8s]
Hero: folds 
Player12: calls $0.02
Player22: calls $0.02
Player16: folds 
Player7: folds 
Player9: calls $0.02
Player20: folds 
Player4: calls $0.01
Player1: checks 
*** FLOP *** [Td 3s Th]
Player4: checks 
Player1: checks 
Player12: checks 
Player22: checks 
Player9: checks 
*** TURN *** [Td 3s Th] [9s]
Player4: checks 
Player1: checks 
Player12: checks 
Player22: bets $0.08
Player9: folds 
Player4: folds 
Player1: folds 
Player12: folds 
Uncalled bet ($0.08) returned to Player22
Player22 collected $0.11 from pot
Player22: doesn't show hand 
*** SUMMARY ***
Total pot $0.11 | Rake $0 
Board [Td 3s Th 9s]
Seat 1: Player20 (button) folded before Flop (didn't bet)
Seat 2: Player4 (small blind) folded on the Turn
Seat 3: Player1 (big blind) folded on the Turn
Seat 4: Hero folded before Flop (didn't bet)
Seat 5: Player12 folded on the Turn
Seat 6: Player22 collected ($0.11)
Seat 7: Player16 folded before Flop (didn't bet)
Seat 8: Player7 folded before Flop (didn't bet)
Seat 9: Player9 folded on the Turn



PokerStars Game #22198294871:  Hold'em No Limit ($0.01/$0.02 USD) - 2010/05/07 0:18:07 WET [2010/05/06 19:18:07 ET]
Table '99999999' 9-max Seat #2 is the button
Seat 1: Player20 ($5.53 in chips) 
Seat 2: Player4 ($0.58 in chips) 
Seat 3: Player1 ($1.98 in chips) 
Seat 4: Hero ($5.81 in chips) 
Seat 5: Player12 ($0.97 in chips) 
Seat 6: Player22 ($2.83 in chips) 
Seat 7: Player16 ($1.42 in chips) 
Seat 8: Player7 ($2.02 in chips) 
Seat 9: Player9 ($1.21 in chips) 
Player1: posts small blind $0.01
Hero: posts big blind $0.02
*** HOLE CARDS ***
Dealt to Hero [9d Qc]
Player12: folds 
Player22: folds 
Player16: folds 
Player7: folds 
Player9: calls $0.02
Player20: raises $0.04 to $0.06
Player4: folds 
Player1: folds 
Hero: folds 
Player9: calls $0.04
*** FLOP *** [6d 4d Qh]
Player9: checks 
Player20: checks 
*** TURN *** [6d 4d Qh] [Ac]
Player9: checks 
Player20: checks 
*** RIVER *** [6d 4d Qh Ac] [Ah]
Player9: bets $0.02
Player20: calls $0.02
*** SHOW DOWN ***
Player9: shows [2d Qd] (two pair, Aces and Queens)
Player20: mucks hand 
Player9 collected $0.19 from pot
*** SUMMARY ***
Total pot $0.19 | Rake $0 
Board [6d 4d Qh Ac Ah]
Seat 1: Player20 mucked [Kc Jd]
Seat 2: Player4 (button) folded before Flop (didn't bet)
Seat 3: Player1 (small blind) folded before Flop
Seat 4: Hero (big blind) folded before Flop
Seat 5: Player12 folded before Flop (didn't bet)
Seat 6: Player22 folded before Flop (didn't bet)
Seat 7: Player16 folded before Flop (didn't bet)
Seat 8: Player7 folded before Flop (didn't bet)
Seat 9: Player9 showed [2d Qd] and won ($0.19) with two pair, Aces and Queens



PokerStars Game #97422269929:  Hold'em No Limit ($0.01/$0.02 USD) - 2010/05/07 0:19:21 WET [2010/05/06 19:19:21 ET]
Table '99999999' 9-max Seat #3 is the button
Seat 1: Player20 ($5.45 in chips) 
Seat 2: Player4 ($0.58 in chips) 
Seat 3: Player1 ($1.97 in chips) 
Seat 4: Hero ($5.79 in chips) 
Seat 5: Player12 ($0.97 in chips) 
Seat 6: Player22 ($2.83 in chips) 
Seat 7: Player16 ($1.42 in chips) 
Seat 8: Player7 ($2.02 in chips) 
Seat 9: Player9 ($1.32 in chips) 
Hero: posts small blind $0.01
Player12: posts big blind $0.02
*** HOLE CARDS ***
Dealt to Hero [Td 2h]
Player22: folds 
Player16: raises $0.06 to $0.08
Player7: folds 
Player9: folds 
Player20: folds 
Player4: folds 
Player1: calls $0.08
Hero: folds 
Player12: folds 
*** FLOP *** [9c 7d 3h]
Player16: checks 
Player1: checks 
*** TURN *** [9c 7d 3h] [9h]
Player16: bets $0.06
Player1: folds 
Uncalled bet ($0.06) returned to Player16
Player16 collected $0.19 from pot
Player16: doesn't show hand 
*** SUMMARY ***
Total pot $0.19 | Rake $0 
Board [9c 7d 3h 9h]
Seat 1: Player20 folded before Flop (didn't bet)
Seat 2: Player4 folded before Flop (didn't bet)
Seat 3: Player1 (button) folded on the Turn
Seat 4: Hero (small blind) folded before Flop
Seat 5: Player12 (big blind) folded before Flop
Seat 6: Player22 folded before Flop (didn't bet)
Seat 7: Player16 collected ($0.19)
Seat 8: Player7 folded before Flop (didn't bet)
Seat 9: Player9 folded before Flop (didn't bet)



PokerStars Game #18011288181:  Hold'em No Limit ($0.01/$0.02 USD) - 2010/05/07 0:20:17 WET [2010/05/06 19:20:17 ET]
Table '99999999' 9-max Seat #4 is the button
Seat 1: Player20 ($5.45 in chips) 
Seat 2: Player4 ($0.58 in chips) 
Seat 3: Player1 ($1.89 in chips) 
Seat 4: Hero ($5.78 in chips) 
Seat 5: Player12 ($0.95 in chips) 
Seat 6: Player22 ($2.83 in chips) 
Seat 7: Player16 ($1.53 in chips) 
Seat 8: Player7 ($2.02 in chips) 
Seat 9: Player9 ($1.32 in chips) 
Player12: posts small blind $0.01
Player22: posts big blind $0.02
*** HOLE CARDS ***
Dealt to Hero [5d 6s]
Player16: folds 
Player16 leaves the table
Player7: folds 
Player9: folds 
Player20: raises $0.04 to $0.06
Player4: folds 
Player1: folds 
Hero: folds 
Player12: calls $0.05
Player22: calls $0.04
*** FLOP *** [Ts Kc Jd]
Player6 joins the table at seat #7 
Player12: checks 
Player22: bets $0.06
Player20: folds 
Player12: folds 
Uncalled bet ($0.06) returned to Player22
Player22 collected $0.18 from pot
Player22: doesn't show hand 
*** SUMMARY ***
Total pot $0.18 | Rake $0 
Board [Ts Kc Jd]
Seat 1: Player20 folded on the Flop
Seat 2: Player4 folded before Flop (didn't bet)
Seat 3: Player1 folded before Flop (didn't bet)
Seat 4: Hero (button) folded before Flop (didn't bet)
Seat 5: Player12 (small blind) folded on the Flop
Seat 6: Player22 (big blind) collected ($0.18)
Seat 7: Player16 folded before Flop (didn't bet)
Seat 8: Player7 folded before Flop (didn't bet)
Seat 9: Player9 folded before Flop (didn't bet)



PokerStars Game #45432821411:  Hold'em No Limit ($0.01/$0.02 USD) - 2010/05/07 0:21:04 WET [2010/05/06 19:21:04 ET]
Table '99999999' 9-max Seat #5 is the button
Seat 1: Player20 ($5.39 in chips) 
Seat 2: Player4 ($0.58 in chips) 
Seat 3: Player1 ($1.89 in chips) 
Seat 4: Hero ($5.78 in chips) 
Seat 5: Player12 ($0.89 in chips) 
Seat 6: Player22 ($2.95 in chips) 
Seat 7: Player6 ($2 in chips) 
Seat 8: Player7 ($2.02 in chips) 
Seat 9: Player9 ($1.32 in chips) 
Player22: posts small blind $0.01
Player6: posts big blind $0.02
*** HOLE CARDS ***
Dealt to Hero [Ks Jd]
Player7: calls $0.02
Player9: folds 
Player20: folds 
Player4: calls $0.02
Player1: raises $0.04 to $0.06
Hero: folds 
Player12: folds 
Player22: calls $0.05
Player6: calls $0.04
Player7: calls $0.04
Player4: calls $0.04
*** FLOP *** [5c 3h 4s]
Player22: bets $0.04
Player6: calls $0.04
Player7: folds 
Player4: calls $0.04
Player1: calls $0.04
*** TURN *** [5c 3h 4s] [Qh]
Player22: checks 
Player6: checks 
Player4: checks 
Player1: checks 
*** RIVER *** [5c 3h 4s Qh] [6h]
Player22: bets $0.04
Player6: folds 
Player4: folds 
Player1: folds 
Uncalled bet ($0.04) returned to Player22
Player22 collected $0.46 from pot
Player22: doesn't show hand 
*** SUMMARY ***
Total pot $0.46 | Rake $0 
Board [5c 3h 4s Qh 6h]
Seat 1: Player20 folded before Flop (didn't bet)
Seat 2: Player4 folded on the River
Seat 3: Player1 folded on the River
Seat 4: Hero folded before Flop (didn't bet)
Seat 5: Player12 (button) folded before Flop (didn't bet)
Seat 6: Player22 (small blind) collected ($0.46)
Seat 7: Player6 (big blind) folded on the River
Seat 8: Player7 folded on the Flop
Seat 9: Player9 folded before Flop (didn't bet)



PokerStars Game #10551491588:  Hold'em No Limit ($0.01/$0.02 USD) - 2010/05/07 0:22:27 WET [2010/05/06 19:22:27 ET]
Table '99999999' 9-max Seat #6 is the button
Seat 1: Player20 ($5.39 in chips) 
Seat 2: Player4 ($0.48 in chips) 
Seat 3: Player1 ($1.79 in chips) 
Seat 4: Hero ($5.78 in chips) 
Seat 5: Player12 ($0.89 in chips) 
Seat 6: Player22 ($3.31 in chips) 
Seat 7: Player6 ($1.90 in chips) 
Seat 8: Player7 ($2 in chips) 
Seat 9: Player9 ($1.32 in chips) 
Player6: posts small blind $0.01
Player7: posts big blind $0.02
*** HOLE CARDS ***
Dealt to Hero [Qs 9s]
Player9: folds 
Player20: folds 
Player4: folds 
Player1: folds 
Hero: raises $0.04 to $0.06
Player12: folds 
Player22: folds 
Player6: folds 
Player7: folds 
Uncalled bet ($0.04) returned to Hero
Hero collected $0.05 from pot
Hero: doesn't show hand 
*** SUMMARY ***
Total pot $0.05 | Rake $0 
Seat 1: Player20 folded before Flop (didn't bet)
Seat 2: Player4 folded before Flop (didn't bet)
Seat 3: Player1 folded before Flop (didn't bet)
Seat 4: Hero collected ($0.05)
Seat 5: Player12 folded before Flop (didn't bet)
Seat 6: Player22 (button) folded before Flop (didn't bet)
Seat 7: Player6 (small blind) folded before Flop
Seat 8: Player7 (big blind) folded before Flop
Seat 9: Player9 folded before Flop (didn't bet)



PokerStars Game #19037115169:  Hold'em No Limit ($0.01/$0.02 USD) - 2010/05/07 0:22:56 WET [2010/05/06 19:22:56 ET]
Table '99999999' 9-max Seat #7 is the button
Seat 1: Player20 ($5.39 in chips) 
Seat 2: Player4 ($0.48 in chips) 
Seat 3: Player1 ($1.79 in chips) 
Seat 4: Hero ($5.81 in chips) 
Seat 5: Player12 ($0.89 in chips) 
Seat 6: Player22 ($3.31 in chips) 
Seat 7: Player6 ($1.89 in chips) 
Seat 8: Player7 ($2 in chips) 
Seat 9: Player9 ($1.32 in chips) 
Player7: posts small blind $0.01
Player9: posts big blind $0.02
*** HOLE CARDS ***
Dealt to Hero [4d Js]
Player20: folds 
Player4: folds 
Player1: folds 
Hero: folds 
Player12: folds 
Player22: folds 
Player6: folds 
Player7: folds 
Uncalled bet ($0.01) returned to Player9
Player9 collected $0.02 from pot
*** SUMMARY ***
Total pot $0.02 | Rake $0 
Seat 1: Player20 folded before Flop (didn't bet)
Seat 2: Player4 folded before Flop (didn't bet)
Seat 3: Player1 folded before Flop (didn't bet)
Seat 4: Hero folded before Flop (didn't bet)
Seat 5: Player12 folded before Flop (didn't bet)
Seat 6: Player22 folded before Flop (didn't bet)
Seat 7: Player6 (button) folded before Flop (didn't bet)
Seat 8: Player7 (small blind) folded before Flop
Seat 9: Player9 (big blind) collected ($0.02)



PokerStars Game #26447108451:  Hold'em No Limit ($0.01/$0.02 USD) - 2010/05/07 0:23:19 WET [2010/05/06 19:23:19 ET]
Table '99999999' 9-max Seat #8 is the button
Seat 1: Player20 ($5.39 in chips) 
Seat 2: Player4 ($0.48 in chips) 
Seat 3: Player1 ($1.79 in chips) 
Seat 4: Hero ($5.81 in chips) 
Seat 5: Player12 ($0.89 in chips) 
Seat 6: Player22 ($3.31 in chips) 
Seat 7: Player6 ($1.89 in chips) 
Seat 8: Player7 ($2 in chips) 
Seat 9: Player9 ($1.33 in chips) 
Player9: posts small blind $0.01
Player20: posts big blind $0.02
*** HOLE CARDS ***
Dealt to Hero [Qd 2s]
Player4: folds 
Player1 has timed out
Player1: folds 
Hero: folds 
Player12: calls $0.02
Player22: folds 
Player6: folds 
Player7: folds 
Player9: calls $0.01
Player20: checks 
*** FLOP *** [Qs 6d 4s]
Player9: checks 
Player20: checks 
Player12: bets $0.02
Player9: folds 
Player20: folds 
Uncalled bet ($0.02) returned to Player12
Player12 collected $0.06 from pot
*** SUMMARY ***
Total pot $0.06 | Rake $0 
Board [Qs 6d 4s]
Seat 1: Player20 (big blind) folded on the Flop
Seat 2: Player4 folded before Flop (didn't bet)
Seat 3: Player1 folded before Flop (didn't bet)
Seat 4: Hero folded before Flop (didn't bet)
Seat 5: Player12 collected ($0.06)
Seat 6: Player22 folded before Flop (didn't bet)
Seat 7: Player6 folded before Flop (didn't bet)
Seat 8: Player7 (button) folded before Flop (didn't bet)
Seat 9: Player9 (small blind) folded on the Flop



PokerStars Game #16631106221:  Hold'em No Limit ($0.01/$0.02 USD) - 2010/05/07 0:24:07 WET [2010/05/06 19:24:07 ET]
Table '99999999' 9-max Seat #9 is the button
Seat 1: Player20 ($5.37 in chips) 
Seat 2: Player4 ($0.48 in chips) 
Seat 3: Player1 ($1.79 in chips) 
Seat 4: Hero ($5.81 in chips) 
Seat 5: Player12 ($0.93 in chips) 
Seat 6: Player22 ($3.31 in chips) 
Seat 7: Player6 ($1.89 in chips) 
Seat 8: Player7 ($2 in chips) 
Seat 9: Player9 ($1.31 in chips) 
Player20: posts small blind $0.01
Player4: posts big blind $0.02
*** HOLE CARDS ***
Dealt to Hero [Tc 6c]
Player1: folds 
Hero: folds 
Player12: folds 
Player22: folds 
Player6: folds 
Player7: folds 
Player9: folds 
Player20: calls $0.01
Player4: checks 
*** FLOP *** [4h 7d Td]
Player20: checks 
Player4: checks 
*** TURN *** [4h 7d Td] [3d]
Player20: checks 
Player4: checks 
*** RIVER *** [4h 7d Td 3d] [Qs]
Player20: bets $0.04
Player4: folds 
Uncalled bet ($0.04) returned to Player20
Player20 collected $0.04 from pot
Player20: doesn't show hand 
*** SUMMARY ***
Total pot $0.04 | Rake $0 
Board [4h 7d Td 3d Qs]
Seat 1: Player20 (small blind) collected ($0.04)
Seat 2: Player4 (big blind) folded on the River
Seat 3: Player1 folded before Flop (didn't bet)
Seat 4: Hero folded before Flop (didn't bet)
Seat 5: Player12 folded before Flop (didn't bet)
Seat 6: Player22 folded before Flop (didn't bet)
Seat 7: Player6 folded before Flop (didn't bet)
Seat 8: Player7 folded before Flop (didn't bet)
Seat 9: Player9 (button) folded before Flop (didn't bet)




